GGATAGTTTAC -> GATAGTTTACC
GATAGTTTACC -> ATAGTTTACCA
ATAGTTTACCA -> TAGTTTACCAA
TAGTTTACCAA -> AGTTTACCAAA
AGTTTACCAAA -> GTTTACCAAAG
GTTTACCAAAG -> TTTACCAAAGG
TTTACCAAAGG -> TTACCAAAGGC
TTACCAAAGGC -> TACCAAAGGCT
TACCAAAGGCT -> ACCAAAGGCTC
ACCAAAGGCTC -> CCAAAGGCTCT
CCAAAGGCTCT -> CAAAGGCTCTT
CAAAGGCTCTT -> AAAGGCTCTTG
AAAGGCTCTTG -> AAGGCTCTTGG
AAGGCTCTTGG -> AGGCTCTTGGA
AGGCTCTTGGA -> GGCTCTTGGAA
GGCTCTTGGAA -> GCTCTTGGAAG
GCTCTTGGAAG -> CTCTTGGAAGG
CTCTTGGAAGG -> TCTTGGAAGGG
TCTTGGAAGGG -> CTTGGAAGGGG
CTTGGAAGGGG -> TTGGAAGGGGT
TTGGAAGGGGT -> TGGAAGGGGTT
TGGAAGGGGTT -> GGAAGGGGTTT
GGAAGGGGTTT -> GAAGGGGTTTA
GAAGGGGTTTA -> AAGGGGTTTAC
AAGGGGTTTAC -> AGGGGTTTACC
AGGGGTTTACC -> GGGGTTTACCG
GGGGTTTACCG -> GGGTTTACCGC
GGGTTTACCGC -> GGTTTACCGCC
GGTTTACCGCC -> GTTTACCGCCG
GTTTACCGCCG -> TTTACCGCCGC
TTTACCGCCGC -> TTACCGCCGCG
TTACCGCCGCG -> TACCGCCGCGA
TACCGCCGCGA -> ACCGCCGCGAC
ACCGCCGCGAC -> CCGCCGCGACC
CCGCCGCGACC -> CGCCGCGACCG
CGCCGCGACCG -> GCCGCGACCGT
GCCGCGACCGT -> CCGCGACCGTG
CCGCGACCGTG -> CGCGACCGTGA
CGCGACCGTGA -> GCGACCGTGAG
GCGACCGTGAG -> CGACCGTGAGC
CGACCGTGAGC -> GACCGTGAGCA
GACCGTGAGCA -> ACCGTGAGCAT
ACCGTGAGCAT -> CCGTGAGCATC
CCGTGAGCATC -> CGTGAGCATCT
CGTGAGCATCT -> GTGAGCATCTT
GTGAGCATCTT -> TGAGCATCTTT
TGAGCATCTTT -> GAGCATCTTTG
GAGCATCTTTG -> AGCATCTTTGA
AGCATCTTTGA -> GCATCTTTGAT
GCATCTTTGAT -> CATCTTTGATG
CATCTTTGATG -> ATCTTTGATGA
ATCTTTGATGA -> TCTTTGATGAA
TCTTTGATGAA -> CTTTGATGAAG
CTTTGATGAAG -> TTTGATGAAGT
TTTGATGAAGT -> TTGATGAAGTA
TTGATGAAGTA -> TGATGAAGTAT
TGATGAAGTAT -> GATGAAGTATT
GATGAAGTATT -> ATGAAGTATTG
ATGAAGTATTG -> TGAAGTATTGT
TGAAGTATTGT -> GAAGTATTGTG
GAAGTATTGTG -> AAGTATTGTGA
AAGTATTGTGA -> AGTATTGTGAC
AGTATTGTGAC -> GTATTGTGACT
GTATTGTGACT -> TATTGTGACTG
TATTGTGACTG -> ATTGTGACTGG
ATTGTGACTGG -> TTGTGACTGGG
TTGTGACTGGG -> TGTGACTGGGT
TGTGACTGGGT -> GTGACTGGGTA
GTGACTGGGTA -> TGACTGGGTAC
TGACTGGGTAC -> GACTGGGTACT
GACTGGGTACT -> ACTGGGTACTC
ACTGGGTACTC -> CTGGGTACTCA
CTGGGTACTCA -> TGGGTACTCAC
TGGGTACTCAC -> GGGTACTCACC
GGGTACTCACC -> GGTACTCACCC
GGTACTCACCC -> GTACTCACCCA
GTACTCACCCA -> TACTCACCCAC
TACTCACCCAC -> ACTCACCCACG
ACTCACCCACG -> CTCACCCACGG
CTCACCCACGG -> TCACCCACGGC
TCACCCACGGC -> CACCCACGGCT
CACCCACGGCT -> ACCCACGGCTA
ACCCACGGCTA -> CCCACGGCTAC
CCCACGGCTAC -> CCACGGCTACG
CCACGGCTACG -> CACGGCTACGA
CACGGCTACGA -> ACGGCTACGAA
ACGGCTACGAA -> CGGCTACGAAA
CGGCTACGAAA -> GGCTACGAAAA
GGCTACGAAAA -> GCTACGAAAAC
GCTACGAAAAC -> CTACGAAAACA
CTACGAAAACA -> TACGAAAACAC
TACGAAAACAC -> ACGAAAACACG
ACGAAAACACG -> CGAAAACACGT
CGAAAACACGT -> GAAAACACGTT
GAAAACACGTT -> AAAACACGTTG
AAAACACGTTG -> AAACACGTTGA
AAACACGTTGA -> AACACGTTGAA
AACACGTTGAA -> ACACGTTGAAG
ACACGTTGAAG -> CACGTTGAAGC
CACGTTGAAGC -> ACGTTGAAGCC
ACGTTGAAGCC -> CGTTGAAGCCC
CGTTGAAGCCC -> GTTGAAGCCCA
GTTGAAGCCCA -> TTGAAGCCCAC
TTGAAGCCCAC -> TGAAGCCCACT
TGAAGCCCACT -> GAAGCCCACTG
GAAGCCCACTG -> AAGCCCACTGC
AAGCCCACTGC -> AGCCCACTGCG
AGCCCACTGCG -> GCCCACTGCGT
GCCCACTGCGT -> CCCACTGCGTA
CCCACTGCGTA -> CCACTGCGTAG
CCACTGCGTAG -> CACTGCGTAGA
CACTGCGTAGA -> ACTGCGTAGAT
ACTGCGTAGAT -> CTGCGTAGATC
CTGCGTAGATC -> TGCGTAGATCG
TGCGTAGATCG -> GCGTAGATCGT
GCGTAGATCGT -> CGTAGATCGTA
CGTAGATCGTA -> GTAGATCGTAG
GTAGATCGTAG -> TAGATCGTAGC
TAGATCGTAGC -> AGATCGTAGCG
AGATCGTAGCG -> GATCGTAGCGG
GATCGTAGCGG -> ATCGTAGCGGC
ATCGTAGCGGC -> TCGTAGCGGCC
TCGTAGCGGCC -> CGTAGCGGCCC
CGTAGCGGCCC -> GTAGCGGCCCT
GTAGCGGCCCT -> TAGCGGCCCTG
TAGCGGCCCTG -> AGCGGCCCTGA
AGCGGCCCTGA -> GCGGCCCTGAG
GCGGCCCTGAG -> CGGCCCTGAGC
CGGCCCTGAGC -> GGCCCTGAGCT
GGCCCTGAGCT -> GCCCTGAGCTT
GCCCTGAGCTT -> CCCTGAGCTTC
CCCTGAGCTTC -> CCTGAGCTTCA
CCTGAGCTTCA -> CTGAGCTTCAT
CTGAGCTTCAT -> TGAGCTTCATC
TGAGCTTCATC -> GAGCTTCATCT
GAGCTTCATCT -> AGCTTCATCTG
AGCTTCATCTG -> GCTTCATCTGC
GCTTCATCTGC -> CTTCATCTGCC
CTTCATCTGCC -> TTCATCTGCCA
TTCATCTGCCA -> TCATCTGCCAG
TCATCTGCCAG -> CATCTGCCAGG
CATCTGCCAGG -> ATCTGCCAGGT
ATCTGCCAGGT -> TCTGCCAGGTA
TCTGCCAGGTA -> CTGCCAGGTAA
CTGCCAGGTAA -> TGCCAGGTAAG
TGCCAGGTAAG -> GCCAGGTAAGT
GCCAGGTAAGT -> CCAGGTAAGTC
CCAGGTAAGTC -> CAGGTAAGTCC
CAGGTAAGTCC -> AGGTAAGTCCT
AGGTAAGTCCT -> GGTAAGTCCTA
GGTAAGTCCTA -> GTAAGTCCTAT
GTAAGTCCTAT -> TAAGTCCTATG
TAAGTCCTATG -> AAGTCCTATGT
AAGTCCTATGT -> AGTCCTATGTA
AGTCCTATGTA -> GTCCTATGTAC
GTCCTATGTAC -> TCCTATGTACT
TCCTATGTACT -> CCTATGTACTC
CCTATGTACTC -> CTATGTACTCC
CTATGTACTCC -> TATGTACTCCG
TATGTACTCCG -> ATGTACTCCGC
ATGTACTCCGC -> TGTACTCCGCG
TGTACTCCGCG -> GTACTCCGCGG
GTACTCCGCGG -> TACTCCGCGGG
TACTCCGCGGG -> ACTCCGCGGGT
ACTCCGCGGGT -> CTCCGCGGGTG
CTCCGCGGGTG -> TCCGCGGGTGT
TCCGCGGGTGT -> CCGCGGGTGTT
CCGCGGGTGTT -> CGCGGGTGTTG
CGCGGGTGTTG -> GCGGGTGTTGT
GCGGGTGTTGT -> CGGGTGTTGTT
CGGGTGTTGTT -> GGGTGTTGTTT
GGGTGTTGTTT -> GGTGTTGTTTG
GGTGTTGTTTG -> GTGTTGTTTGT
GTGTTGTTTGT -> TGTTGTTTGTA
TGTTGTTTGTA -> GTTGTTTGTAT
GTTGTTTGTAT -> TTGTTTGTATA
TTGTTTGTATA -> TGTTTGTATAT
TGTTTGTATAT -> GTTTGTATATT
GTTTGTATATT -> TTTGTATATTT
TTTGTATATTT -> TTGTATATTTG
TTGTATATTTG -> TGTATATTTGA
TGTATATTTGA -> GTATATTTGAC
GTATATTTGAC -> TATATTTGACA
TATATTTGACA -> ATATTTGACAG
ATATTTGACAG -> TATTTGACAGT
TATTTGACAGT -> ATTTGACAGTA
ATTTGACAGTA -> TTTGACAGTAA
TTTGACAGTAA -> TTGACAGTAAA
TTGACAGTAAA -> TGACAGTAAAA
TGACAGTAAAA -> GACAGTAAAAC
GACAGTAAAAC -> ACAGTAAAACC
ACAGTAAAACC -> CAGTAAAACCG
CAGTAAAACCG -> AGTAAAACCGG
AGTAAAACCGG -> GTAAAACCGGT
GTAAAACCGGT -> TAAAACCGGTA
TAAAACCGGTA -> AAAACCGGTAC
AAAACCGGTAC -> AAACCGGTACC
AAACCGGTACC -> AACCGGTACCG
AACCGGTACCG -> ACCGGTACCGA
ACCGGTACCGA -> CCGGTACCGAA
CCGGTACCGAA -> CGGTACCGAAT
CGGTACCGAAT -> GGTACCGAATG
GGTACCGAATG -> GTACCGAATGC
GTACCGAATGC -> TACCGAATGCC
TACCGAATGCC -> ACCGAATGCCC
ACCGAATGCCC -> CCGAATGCCCT
CCGAATGCCCT -> CGAATGCCCTG
CGAATGCCCTG -> GAATGCCCTGT
GAATGCCCTGT -> AATGCCCTGTT
AATGCCCTGTT -> ATGCCCTGTTT
ATGCCCTGTTT -> TGCCCTGTTTA
TGCCCTGTTTA -> GCCCTGTTTAT
GCCCTGTTTAT -> CCCTGTTTATA
CCCTGTTTATA -> CCTGTTTATAT
CCTGTTTATAT -> CTGTTTATATG
CTGTTTATATG -> TGTTTATATGA
TGTTTATATGA -> GTTTATATGAT
GTTTATATGAT -> TTTATATGATA
TTTATATGATA -> TTATATGATAT
TTATATGATAT -> TATATGATATT
TATATGATATT -> ATATGATATTA
ATATGATATTA -> TATGATATTAG
TATGATATTAG -> ATGATATTAGT
ATGATATTAGT -> TGATATTAGTG
TGATATTAGTG -> GATATTAGTGG
GATATTAGTGG -> ATATTAGTGGA
ATATTAGTGGA -> TATTAGTGGAA
TATTAGTGGAA -> ATTAGTGGAAA
ATTAGTGGAAA -> TTAGTGGAAAC
TTAGTGGAAAC -> TAGTGGAAACA
TAGTGGAAACA -> AGTGGAAACAA
AGTGGAAACAA -> GTGGAAACAAC
GTGGAAACAAC -> TGGAAACAACC
TGGAAACAACC -> GGAAACAACCG
GGAAACAACCG -> GAAACAACCGA
GAAACAACCGA -> AAACAACCGAA
AAACAACCGAA -> AACAACCGAAG
AACAACCGAAG -> ACAACCGAAGC
ACAACCGAAGC -> CAACCGAAGCC
CAACCGAAGCC -> AACCGAAGCCC
AACCGAAGCCC -> ACCGAAGCCCT
ACCGAAGCCCT -> CCGAAGCCCTA
CCGAAGCCCTA -> CGAAGCCCTAG
CGAAGCCCTAG -> GAAGCCCTAGT
GAAGCCCTAGT -> AAGCCCTAGTC
AAGCCCTAGTC -> AGCCCTAGTCG
AGCCCTAGTCG -> GCCCTAGTCGA
GCCCTAGTCGA -> CCCTAGTCGAC
CCCTAGTCGAC -> CCTAGTCGACG
CCTAGTCGACG -> CTAGTCGACGA
CTAGTCGACGA -> TAGTCGACGAG
TAGTCGACGAG -> AGTCGACGAGA
AGTCGACGAGA -> GTCGACGAGAG
GTCGACGAGAG -> TCGACGAGAGG
TCGACGAGAGG -> CGACGAGAGGG
CGACGAGAGGG -> GACGAGAGGGC
GACGAGAGGGC -> ACGAGAGGGCA
ACGAGAGGGCA -> CGAGAGGGCAT
CGAGAGGGCAT -> GAGAGGGCATT
GAGAGGGCATT -> AGAGGGCATTC
AGAGGGCATTC -> GAGGGCATTCG
GAGGGCATTCG -> AGGGCATTCGC
AGGGCATTCGC -> GGGCATTCGCA
GGGCATTCGCA -> GGCATTCGCAC
GGCATTCGCAC -> GCATTCGCACC
GCATTCGCACC -> CATTCGCACCC
CATTCGCACCC -> ATTCGCACCCA
ATTCGCACCCA -> TTCGCACCCAC
TTCGCACCCAC -> TCGCACCCACT
TCGCACCCACT -> CGCACCCACTG
CGCACCCACTG -> GCACCCACTGA
GCACCCACTGA -> CACCCACTGAT
CACCCACTGAT -> ACCCACTGATA
ACCCACTGATA -> CCCACTGATAT
CCCACTGATAT -> CCACTGATATT
CCACTGATATT -> CACTGATATTT
CACTGATATTT -> ACTGATATTTT
ACTGATATTTT -> CTGATATTTTA
CTGATATTTTA -> TGATATTTTAA
TGATATTTTAA -> GATATTTTAAT
GATATTTTAAT -> ATATTTTAATT
ATATTTTAATT -> TATTTTAATTC
TATTTTAATTC -> ATTTTAATTCC
ATTTTAATTCC -> TTTTAATTCCG
TTTTAATTCCG -> TTTAATTCCGA
TTTAATTCCGA -> TTAATTCCGAC
TTAATTCCGAC -> TAATTCCGACA
TAATTCCGACA -> AATTCCGACAT
AATTCCGACAT -> ATTCCGACATG
ATTCCGACATG -> TTCCGACATGC
TTCCGACATGC -> TCCGACATGCC
TCCGACATGCC -> CCGACATGCCG
CCGACATGCCG -> CGACATGCCGC
CGACATGCCGC -> GACATGCCGCT
GACATGCCGCT -> ACATGCCGCTC
ACATGCCGCTC -> CATGCCGCTCT
CATGCCGCTCT -> ATGCCGCTCTG
ATGCCGCTCTG -> TGCCGCTCTGT
TGCCGCTCTGT -> GCCGCTCTGTA
GCCGCTCTGTA -> CCGCTCTGTAT
CCGCTCTGTAT -> CGCTCTGTATG
CGCTCTGTATG -> GCTCTGTATGA
GCTCTGTATGA -> CTCTGTATGAG
CTCTGTATGAG -> TCTGTATGAGA
TCTGTATGAGA -> CTGTATGAGAT
CTGTATGAGAT -> TGTATGAGATT
TGTATGAGATT -> GTATGAGATTC
GTATGAGATTC -> TATGAGATTCC
TATGAGATTCC -> ATGAGATTCCA
ATGAGATTCCA -> TGAGATTCCAA
TGAGATTCCAA -> GAGATTCCAAA
GAGATTCCAAA -> AGATTCCAAAA
AGATTCCAAAA -> GATTCCAAAAG
GATTCCAAAAG -> ATTCCAAAAGA
ATTCCAAAAGA -> TTCCAAAAGAA
TTCCAAAAGAA -> TCCAAAAGAAA
TCCAAAAGAAA -> CCAAAAGAAAG
CCAAAAGAAAG -> CAAAAGAAAGC
CAAAAGAAAGC -> AAAAGAAAGCG
AAAAGAAAGCG -> AAAGAAAGCGG
AAAGAAAGCGG -> AAGAAAGCGGG
AAGAAAGCGGG -> AGAAAGCGGGG
AGAAAGCGGGG -> GAAAGCGGGGT
GAAAGCGGGGT -> AAAGCGGGGTG
AAAGCGGGGTG -> AAGCGGGGTGG
AAGCGGGGTGG -> AGCGGGGTGGC
AGCGGGGTGGC -> GCGGGGTGGCC
GCGGGGTGGCC -> CGGGGTGGCCG
CGGGGTGGCCG -> GGGGTGGCCGT
GGGGTGGCCGT -> GGGTGGCCGTC
GGGTGGCCGTC -> GGTGGCCGTCA
GGTGGCCGTCA -> GTGGCCGTCAG
GTGGCCGTCAG -> TGGCCGTCAGG
TGGCCGTCAGG -> GGCCGTCAGGG
GGCCGTCAGGG -> GCCGTCAGGGA
GCCGTCAGGGA -> CCGTCAGGGAG
CCGTCAGGGAG -> CGTCAGGGAGC
CGTCAGGGAGC -> GTCAGGGAGCC
GTCAGGGAGCC -> TCAGGGAGCCA
TCAGGGAGCCA -> CAGGGAGCCAG
CAGGGAGCCAG -> AGGGAGCCAGA
AGGGAGCCAGA -> GGGAGCCAGAC
GGGAGCCAGAC -> GGAGCCAGACC
GGAGCCAGACC -> GAGCCAGACCC
GAGCCAGACCC -> AGCCAGACCCG
AGCCAGACCCG -> GCCAGACCCGG
GCCAGACCCGG -> CCAGACCCGGG
CCAGACCCGGG -> CAGACCCGGGT
CAGACCCGGGT -> AGACCCGGGTC
AGACCCGGGTC -> GACCCGGGTCA
GACCCGGGTCA -> ACCCGGGTCAT
ACCCGGGTCAT -> CCCGGGTCATA
CCCGGGTCATA -> CCGGGTCATAA
CCGGGTCATAA -> CGGGTCATAAG
CGGGTCATAAG -> GGGTCATAAGC
GGGTCATAAGC -> GGTCATAAGCA
GGTCATAAGCA -> GTCATAAGCAT
GTCATAAGCAT -> TCATAAGCATT
TCATAAGCATT -> CATAAGCATTC
CATAAGCATTC -> ATAAGCATTCT
ATAAGCATTCT -> TAAGCATTCTC
TAAGCATTCTC -> AAGCATTCTCT
AAGCATTCTCT -> AGCATTCTCTC
AGCATTCTCTC -> GCATTCTCTCG
GCATTCTCTCG -> CATTCTCTCGC
CATTCTCTCGC -> ATTCTCTCGCG
ATTCTCTCGCG -> TTCTCTCGCGG
TTCTCTCGCGG -> TCTCTCGCGGT
TCTCTCGCGGT -> CTCTCGCGGTT
CTCTCGCGGTT -> TCTCGCGGTTT
TCTCGCGGTTT -> CTCGCGGTTTA
CTCGCGGTTTA -> TCGCGGTTTAG
TCGCGGTTTAG -> CGCGGTTTAGA
CGCGGTTTAGA -> GCGGTTTAGAA
GCGGTTTAGAA -> CGGTTTAGAAA
CGGTTTAGAAA -> GGTTTAGAAAG
GGTTTAGAAAG -> GTTTAGAAAGT
GTTTAGAAAGT -> TTTAGAAAGTA
TTTAGAAAGTA -> TTAGAAAGTAT
TTAGAAAGTAT -> TAGAAAGTATA
TAGAAAGTATA -> AGAAAGTATAG
AGAAAGTATAG -> GAAAGTATAGT
GAAAGTATAGT -> AAAGTATAGTT
AAAGTATAGTT -> AAGTATAGTTC
AAGTATAGTTC -> AGTATAGTTCT
AGTATAGTTCT -> GTATAGTTCTA
GTATAGTTCTA -> TATAGTTCTAT
TATAGTTCTAT -> ATAGTTCTATC
ATAGTTCTATC -> TAGTTCTATCC
TAGTTCTATCC -> AGTTCTATCCA
AGTTCTATCCA -> GTTCTATCCAA
GTTCTATCCAA -> TTCTATCCAAG
TTCTATCCAAG -> TCTATCCAAGA
TCTATCCAAGA -> CTATCCAAGAA
CTATCCAAGAA -> TATCCAAGAAT
TATCCAAGAAT -> ATCCAAGAATT
ATCCAAGAATT -> TCCAAGAATTT
TCCAAGAATTT -> CCAAGAATTTG
CCAAGAATTTG -> CAAGAATTTGC
CAAGAATTTGC -> AAGAATTTGCG
AAGAATTTGCG -> AGAATTTGCGG
AGAATTTGCGG -> GAATTTGCGGT
GAATTTGCGGT -> AATTTGCGGTC
AATTTGCGGTC -> ATTTGCGGTCC
ATTTGCGGTCC -> TTTGCGGTCCC
TTTGCGGTCCC -> TTGCGGTCCCC
TTGCGGTCCCC -> TGCGGTCCCCC
TGCGGTCCCCC -> GCGGTCCCCCA
GCGGTCCCCCA -> CGGTCCCCCAG
CGGTCCCCCAG -> GGTCCCCCAGA
GGTCCCCCAGA -> GTCCCCCAGAC
GTCCCCCAGAC -> TCCCCCAGACC
TCCCCCAGACC -> CCCCCAGACCT
CCCCCAGACCT -> CCCCAGACCTT
CCCCAGACCTT -> CCCAGACCTTC
CCCAGACCTTC -> CCAGACCTTCA
CCAGACCTTCA -> CAGACCTTCAT
CAGACCTTCAT -> AGACCTTCATG
AGACCTTCATG -> GACCTTCATGA
GACCTTCATGA -> ACCTTCATGAG
ACCTTCATGAG -> CCTTCATGAGA
CCTTCATGAGA -> CTTCATGAGAT
CTTCATGAGAT -> TTCATGAGATT
TTCATGAGATT -> TCATGAGATTG
TCATGAGATTG -> CATGAGATTGG
CATGAGATTGG -> ATGAGATTGGA
ATGAGATTGGA -> TGAGATTGGAG
TGAGATTGGAG -> GAGATTGGAGC
GAGATTGGAGC -> AGATTGGAGCG
AGATTGGAGCG -> GATTGGAGCGC
GATTGGAGCGC -> ATTGGAGCGCC
ATTGGAGCGCC -> TTGGAGCGCCG
TTGGAGCGCCG -> TGGAGCGCCGT
TGGAGCGCCGT -> GGAGCGCCGTT
GGAGCGCCGTT -> GAGCGCCGTTG
GAGCGCCGTTG -> AGCGCCGTTGG
AGCGCCGTTGG -> GCGCCGTTGGA
GCGCCGTTGGA -> CGCCGTTGGAT
CGCCGTTGGAT -> GCCGTTGGATT
GCCGTTGGATT -> CCGTTGGATTC
CCGTTGGATTC -> CGTTGGATTCG
CGTTGGATTCG -> GTTGGATTCGT
GTTGGATTCGT -> TTGGATTCGTC
TTGGATTCGTC -> TGGATTCGTCT
TGGATTCGTCT -> GGATTCGTCTT
GGATTCGTCTT -> GATTCGTCTTA
GATTCGTCTTA -> ATTCGTCTTAC
ATTCGTCTTAC -> TTCGTCTTACC
TTCGTCTTACC -> TCGTCTTACCC
TCGTCTTACCC -> CGTCTTACCCC
CGTCTTACCCC -> GTCTTACCCCA
GTCTTACCCCA -> TCTTACCCCAA
TCTTACCCCAA -> CTTACCCCAAA
CTTACCCCAAA -> TTACCCCAAAT
TTACCCCAAAT -> TACCCCAAATA
TACCCCAAATA -> ACCCCAAATAT
ACCCCAAATAT -> CCCCAAATATC
CCCCAAATATC -> CCCAAATATCC
CCCAAATATCC -> CCAAATATCCT
CCAAATATCCT -> CAAATATCCTG
CAAATATCCTG -> AAATATCCTGT
AAATATCCTGT -> AATATCCTGTC
AATATCCTGTC -> ATATCCTGTCG
ATATCCTGTCG -> TATCCTGTCGG
TATCCTGTCGG -> ATCCTGTCGGG
ATCCTGTCGGG -> TCCTGTCGGGC
TCCTGTCGGGC -> CCTGTCGGGCT
CCTGTCGGGCT -> CTGTCGGGCTT
CTGTCGGGCTT -> TGTCGGGCTTA
TGTCGGGCTTA -> GTCGGGCTTAC
GTCGGGCTTAC -> TCGGGCTTACA
TCGGGCTTACA -> CGGGCTTACAA
CGGGCTTACAA -> GGGCTTACAAT
GGGCTTACAAT -> GGCTTACAATC
GGCTTACAATC -> GCTTACAATCC
GCTTACAATCC -> CTTACAATCCG
CTTACAATCCG -> TTACAATCCGC
TTACAATCCGC -> TACAATCCGCA
TACAATCCGCA -> ACAATCCGCAA
ACAATCCGCAA -> CAATCCGCAAG
CAATCCGCAAG -> AATCCGCAAGA
AATCCGCAAGA -> ATCCGCAAGAA
ATCCGCAAGAA -> TCCGCAAGAAG
TCCGCAAGAAG -> CCGCAAGAAGG
CCGCAAGAAGG -> CGCAAGAAGGA
CGCAAGAAGGA -> GCAAGAAGGAC
GCAAGAAGGAC -> CAAGAAGGACT
CAAGAAGGACT -> AAGAAGGACTT
AAGAAGGACTT -> AGAAGGACTTA
AGAAGGACTTA -> GAAGGACTTAA
GAAGGACTTAA -> AAGGACTTAAT
AAGGACTTAAT -> AGGACTTAATC
AGGACTTAATC -> GGACTTAATCA
GGACTTAATCA -> GACTTAATCAC
GACTTAATCAC -> ACTTAATCACT
ACTTAATCACT -> CTTAATCACTC
CTTAATCACTC -> TTAATCACTCT
TTAATCACTCT -> TAATCACTCTA
TAATCACTCTA -> AATCACTCTAG
AATCACTCTAG -> ATCACTCTAGA
ATCACTCTAGA -> TCACTCTAGAG
TCACTCTAGAG -> CACTCTAGAGG
CACTCTAGAGG -> ACTCTAGAGGG
ACTCTAGAGGG -> CTCTAGAGGGC
CTCTAGAGGGC -> TCTAGAGGGCC
TCTAGAGGGCC -> CTAGAGGGCCA
CTAGAGGGCCA -> TAGAGGGCCAC
TAGAGGGCCAC -> AGAGGGCCACC
AGAGGGCCACC -> GAGGGCCACCG
GAGGGCCACCG -> AGGGCCACCGC
AGGGCCACCGC -> GGGCCACCGCA
GGGCCACCGCA -> GGCCACCGCAT
GGCCACCGCAT -> GCCACCGCATA
GCCACCGCATA -> CCACCGCATAT
CCACCGCATAT -> CACCGCATATA
CACCGCATATA -> ACCGCATATAG
ACCGCATATAG -> CCGCATATAGA
CCGCATATAGA -> CGCATATAGAT
CGCATATAGAT -> GCATATAGATC
GCATATAGATC -> CATATAGATCA
CATATAGATCA -> ATATAGATCAA
ATATAGATCAA -> TATAGATCAAA
TATAGATCAAA -> ATAGATCAAAT
ATAGATCAAAT -> TAGATCAAATT
TAGATCAAATT -> AGATCAAATTC
AGATCAAATTC -> GATCAAATTCG
GATCAAATTCG -> ATCAAATTCGC
ATCAAATTCGC -> TCAAATTCGCG
TCAAATTCGCG -> CAAATTCGCGG
CAAATTCGCGG -> AAATTCGCGGA
AAATTCGCGGA -> AATTCGCGGAC
AATTCGCGGAC -> ATTCGCGGACT
ATTCGCGGACT -> TTCGCGGACTG
TTCGCGGACTG -> TCGCGGACTGT
TCGCGGACTGT -> CGCGGACTGTA
CGCGGACTGTA -> GCGGACTGTAC
GCGGACTGTAC -> CGGACTGTACT
CGGACTGTACT -> GGACTGTACTT
GGACTGTACTT -> GACTGTACTTT
GACTGTACTTT -> ACTGTACTTTT
ACTGTACTTTT -> CTGTACTTTTG
CTGTACTTTTG -> TGTACTTTTGA
TGTACTTTTGA -> GTACTTTTGAC
GTACTTTTGAC -> TACTTTTGACG
TACTTTTGACG -> ACTTTTGACGA
ACTTTTGACGA -> CTTTTGACGAC
CTTTTGACGAC -> TTTTGACGACC
TTTTGACGACC -> TTTGACGACCG
TTTGACGACCG -> TTGACGACCGC
TTGACGACCGC -> TGACGACCGCG
TGACGACCGCG -> GACGACCGCGA
GACGACCGCGA -> ACGACCGCGAG
ACGACCGCGAG -> CGACCGCGAGG
CGACCGCGAGG -> GACCGCGAGGC
GACCGCGAGGC -> ACCGCGAGGCC
ACCGCGAGGCC -> CCGCGAGGCCA
CCGCGAGGCCA -> CGCGAGGCCAC
CGCGAGGCCAC -> GCGAGGCCACC
GCGAGGCCACC -> CGAGGCCACCG
CGAGGCCACCG -> GAGGCCACCGG
GAGGCCACCGG -> AGGCCACCGGT
AGGCCACCGGT -> GGCCACCGGTC
GGCCACCGGTC -> GCCACCGGTCC
GCCACCGGTCC -> CCACCGGTCCG
CCACCGGTCCG -> CACCGGTCCGG
CACCGGTCCGG -> ACCGGTCCGGA
ACCGGTCCGGA -> CCGGTCCGGAT
CCGGTCCGGAT -> CGGTCCGGATA
CGGTCCGGATA -> GGTCCGGATAT
GGTCCGGATAT -> GTCCGGATATC
GTCCGGATATC -> TCCGGATATCC
TCCGGATATCC -> CCGGATATCCT
CCGGATATCCT -> CGGATATCCTC
CGGATATCCTC -> GGATATCCTCC
GGATATCCTCC -> GATATCCTCCA
GATATCCTCCA -> ATATCCTCCAC
ATATCCTCCAC -> TATCCTCCACA
TATCCTCCACA -> ATCCTCCACAA
ATCCTCCACAA -> TCCTCCACAAT
TCCTCCACAAT -> CCTCCACAATA
CCTCCACAATA -> CTCCACAATAT
CTCCACAATAT -> TCCACAATATC
TCCACAATATC -> CCACAATATCT
CCACAATATCT -> CACAATATCTT
CACAATATCTT -> ACAATATCTTT
ACAATATCTTT -> CAATATCTTTG
CAATATCTTTG -> AATATCTTTGA
AATATCTTTGA -> ATATCTTTGAC
ATATCTTTGAC -> TATCTTTGACA
TATCTTTGACA -> ATCTTTGACAC
ATCTTTGACAC -> TCTTTGACACC
TCTTTGACACC -> CTTTGACACCA
CTTTGACACCA -> TTTGACACCAT
TTTGACACCAT -> TTGACACCATA
TTGACACCATA -> TGACACCATAC
TGACACCATAC -> GACACCATACC
GACACCATACC -> ACACCATACCC
ACACCATACCC -> CACCATACCCA
CACCATACCCA -> ACCATACCCAA
ACCATACCCAA -> CCATACCCAAC
CCATACCCAAC -> CATACCCAACC
CATACCCAACC -> ATACCCAACCC
ATACCCAACCC -> TACCCAACCCT
TACCCAACCCT -> ACCCAACCCTC
ACCCAACCCTC -> CCCAACCCTCA
CCCAACCCTCA -> CCAACCCTCAG
CCAACCCTCAG -> CAACCCTCAGT
CAACCCTCAGT -> AACCCTCAGTA
AACCCTCAGTA -> ACCCTCAGTAT
ACCCTCAGTAT -> CCCTCAGTATT
CCCTCAGTATT -> CCTCAGTATTA
CCTCAGTATTA -> CTCAGTATTAA
CTCAGTATTAA -> TCAGTATTAAC
TCAGTATTAAC -> CAGTATTAACA
CAGTATTAACA -> AGTATTAACAA
AGTATTAACAA -> GTATTAACAAA
GTATTAACAAA -> TATTAACAAAT
TATTAACAAAT -> ATTAACAAATT
ATTAACAAATT -> TTAACAAATTA
TTAACAAATTA -> TAACAAATTAA
TAACAAATTAA -> AACAAATTAAG
AACAAATTAAG -> ACAAATTAAGA
ACAAATTAAGA -> CAAATTAAGAA
CAAATTAAGAA -> AAATTAAGAAC
AAATTAAGAAC -> AATTAAGAACC
AATTAAGAACC -> ATTAAGAACCT
ATTAAGAACCT -> TTAAGAACCTG
TTAAGAACCTG -> TAAGAACCTGG
TAAGAACCTGG -> AAGAACCTGGT
AAGAACCTGGT -> AGAACCTGGTT
AGAACCTGGTT -> GAACCTGGTTC
GAACCTGGTTC -> AACCTGGTTCG
AACCTGGTTCG -> ACCTGGTTCGT
ACCTGGTTCGT -> CCTGGTTCGTA
CCTGGTTCGTA -> CTGGTTCGTAG
CTGGTTCGTAG -> TGGTTCGTAGA
TGGTTCGTAGA -> GGTTCGTAGAC
GGTTCGTAGAC -> GTTCGTAGACA
GTTCGTAGACA -> TTCGTAGACAT
TTCGTAGACAT -> TCGTAGACATA
TCGTAGACATA -> CGTAGACATAC
CGTAGACATAC -> GTAGACATACG
GTAGACATACG -> TAGACATACGG
TAGACATACGG -> AGACATACGGT
AGACATACGGT -> GACATACGGTG
GACATACGGTG -> ACATACGGTGC
ACATACGGTGC -> CATACGGTGCG
CATACGGTGCG -> ATACGGTGCGT
ATACGGTGCGT -> TACGGTGCGTG
TACGGTGCGTG -> ACGGTGCGTGG
ACGGTGCGTGG -> CGGTGCGTGGG
CGGTGCGTGGG -> GGTGCGTGGGT
GGTGCGTGGGT -> GTGCGTGGGTC
GTGCGTGGGTC -> TGCGTGGGTCG
TGCGTGGGTCG -> GCGTGGGTCGG
GCGTGGGTCGG -> CGTGGGTCGGT
CGTGGGTCGGT -> GTGGGTCGGTC
GTGGGTCGGTC -> TGGGTCGGTCA
TGGGTCGGTCA -> GGGTCGGTCAA
GGGTCGGTCAA -> GGTCGGTCAAT
GGTCGGTCAAT -> GTCGGTCAATC
GTCGGTCAATC -> TCGGTCAATCC
TCGGTCAATCC -> CGGTCAATCCG
CGGTCAATCCG -> GGTCAATCCGC
GGTCAATCCGC -> GTCAATCCGCT
GTCAATCCGCT -> TCAATCCGCTT
TCAATCCGCTT -> CAATCCGCTTG
CAATCCGCTTG -> AATCCGCTTGG
AATCCGCTTGG -> ATCCGCTTGGT
ATCCGCTTGGT -> TCCGCTTGGTC
TCCGCTTGGTC -> CCGCTTGGTCA
CCGCTTGGTCA -> CGCTTGGTCAG
CGCTTGGTCAG -> GCTTGGTCAGC
GCTTGGTCAGC -> CTTGGTCAGCT
CTTGGTCAGCT -> TTGGTCAGCTA
TTGGTCAGCTA -> TGGTCAGCTAG
TGGTCAGCTAG -> GGTCAGCTAGA
GGTCAGCTAGA -> GTCAGCTAGAT
GTCAGCTAGAT -> TCAGCTAGATG
TCAGCTAGATG -> CAGCTAGATGC
CAGCTAGATGC -> AGCTAGATGCT
AGCTAGATGCT -> GCTAGATGCTT
GCTAGATGCTT -> CTAGATGCTTG
CTAGATGCTTG -> TAGATGCTTGG
TAGATGCTTGG -> AGATGCTTGGA
AGATGCTTGGA -> GATGCTTGGAA
GATGCTTGGAA -> ATGCTTGGAAC
ATGCTTGGAAC -> TGCTTGGAACT
TGCTTGGAACT -> GCTTGGAACTA
GCTTGGAACTA -> CTTGGAACTAC
CTTGGAACTAC -> TTGGAACTACT
TTGGAACTACT -> TGGAACTACTG
TGGAACTACTG -> GGAACTACTGT
GGAACTACTGT -> GAACTACTGTT
GAACTACTGTT -> AACTACTGTTC
AACTACTGTTC -> ACTACTGTTCG
ACTACTGTTCG -> CTACTGTTCGT
CTACTGTTCGT -> TACTGTTCGTA
TACTGTTCGTA -> ACTGTTCGTAT
ACTGTTCGTAT -> CTGTTCGTATA
CTGTTCGTATA -> TGTTCGTATAG
TGTTCGTATAG -> GTTCGTATAGC
GTTCGTATAGC -> TTCGTATAGCT
TTCGTATAGCT -> TCGTATAGCTT
TCGTATAGCTT -> CGTATAGCTTT
CGTATAGCTTT -> GTATAGCTTTG
GTATAGCTTTG -> TATAGCTTTGC
TATAGCTTTGC -> ATAGCTTTGCC
ATAGCTTTGCC -> TAGCTTTGCCT
TAGCTTTGCCT -> AGCTTTGCCTC
AGCTTTGCCTC -> GCTTTGCCTCT
GCTTTGCCTCT -> CTTTGCCTCTC
CTTTGCCTCTC -> TTTGCCTCTCC
TTTGCCTCTCC -> TTGCCTCTCCA
TTGCCTCTCCA -> TGCCTCTCCAT
TGCCTCTCCAT -> GCCTCTCCATC
GCCTCTCCATC -> CCTCTCCATCA
CCTCTCCATCA -> CTCTCCATCAG
CTCTCCATCAG -> TCTCCATCAGC
TCTCCATCAGC -> CTCCATCAGCT
CTCCATCAGCT -> TCCATCAGCTC
TCCATCAGCTC -> CCATCAGCTCG
CCATCAGCTCG -> CATCAGCTCGC
CATCAGCTCGC -> ATCAGCTCGCA
ATCAGCTCGCA -> TCAGCTCGCAG
TCAGCTCGCAG -> CAGCTCGCAGG
CAGCTCGCAGG -> AGCTCGCAGGA,AGCTCGCAGGC
AGCTCGCAGGA -> GCTCGCAGGAA
GCTCGCAGGAA -> CTCGCAGGAAC
CTCGCAGGAAC -> TCGCAGGAACG
TCGCAGGAACG -> CGCAGGAACGT
CGCAGGAACGT -> GCAGGAACGTG
GCAGGAACGTG -> CAGGAACGTGT
CAGGAACGTGT -> AGGAACGTGTA
AGGAACGTGTA -> GGAACGTGTAT
GGAACGTGTAT -> GAACGTGTATA
GAACGTGTATA -> AACGTGTATAC
AACGTGTATAC -> ACGTGTATACC
ACGTGTATACC -> CGTGTATACCA
CGTGTATACCA -> GTGTATACCAA
GTGTATACCAA -> TGTATACCAAG
TGTATACCAAG -> GTATACCAAGC
GTATACCAAGC -> TATACCAAGCC
TATACCAAGCC -> ATACCAAGCCT
ATACCAAGCCT -> TACCAAGCCTA
TACCAAGCCTA -> ACCAAGCCTAG
ACCAAGCCTAG -> CCAAGCCTAGC
CCAAGCCTAGC -> CAAGCCTAGCA
CAAGCCTAGCA -> AAGCCTAGCAC
AAGCCTAGCAC -> AGCCTAGCACT
AGCCTAGCACT -> GCCTAGCACTA
GCCTAGCACTA -> CCTAGCACTAT
CCTAGCACTAT -> CTAGCACTATG
CTAGCACTATG -> TAGCACTATGC
TAGCACTATGC -> AGCACTATGCG
AGCACTATGCG -> GCACTATGCGA
GCACTATGCGA -> CACTATGCGAG
CACTATGCGAG -> ACTATGCGAGA
ACTATGCGAGA -> CTATGCGAGAA
CTATGCGAGAA -> TATGCGAGAAC
TATGCGAGAAC -> ATGCGAGAACG
ATGCGAGAACG -> TGCGAGAACGT
TGCGAGAACGT -> GCGAGAACGTT
GCGAGAACGTT -> CGAGAACGTTC
CGAGAACGTTC -> GAGAACGTTCA
GAGAACGTTCA -> AGAACGTTCAA
AGAACGTTCAA -> GAACGTTCAAC
GAACGTTCAAC -> AACGTTCAACC
AACGTTCAACC -> ACGTTCAACCG
ACGTTCAACCG -> CGTTCAACCGC
CGTTCAACCGC -> GTTCAACCGCA
GTTCAACCGCA -> TTCAACCGCAT
TTCAACCGCAT -> TCAACCGCATG
TCAACCGCATG -> CAACCGCATGT
CAACCGCATGT -> AACCGCATGTC
AACCGCATGTC -> ACCGCATGTCT
ACCGCATGTCT -> CCGCATGTCTT
CCGCATGTCTT -> CGCATGTCTTT
CGCATGTCTTT -> GCATGTCTTTT
GCATGTCTTTT -> CATGTCTTTTA
CATGTCTTTTA -> ATGTCTTTTAA
ATGTCTTTTAA -> TGTCTTTTAAA
TGTCTTTTAAA -> GTCTTTTAAAA
GTCTTTTAAAA -> TCTTTTAAAAA
TCTTTTAAAAA -> CTTTTAAAAAA
CTTTTAAAAAA -> TTTTAAAAAAC
TTTTAAAAAAC -> TTTAAAAAACC
TTTAAAAAACC -> TTAAAAAACCC
TTAAAAAACCC -> TAAAAAACCCT
TAAAAAACCCT -> AAAAAACCCTT
AAAAAACCCTT -> AAAAACCCTTA
AAAAACCCTTA -> AAAACCCTTAC
AAAACCCTTAC -> AAACCCTTACG
AAACCCTTACG -> AACCCTTACGG
AACCCTTACGG -> ACCCTTACGGG
ACCCTTACGGG -> CCCTTACGGGT
CCCTTACGGGT -> CCTTACGGGTG
CCTTACGGGTG -> CTTACGGGTGT
CTTACGGGTGT -> TTACGGGTGTT
TTACGGGTGTT -> TACGGGTGTTG
TACGGGTGTTG -> ACGGGTGTTGA
ACGGGTGTTGA -> CGGGTGTTGAG
CGGGTGTTGAG -> GGGTGTTGAGG
GGGTGTTGAGG -> GGTGTTGAGGC
GGTGTTGAGGC -> GTGTTGAGGCG
GTGTTGAGGCG -> TGTTGAGGCGT
TGTTGAGGCGT -> GTTGAGGCGTA
GTTGAGGCGTA -> TTGAGGCGTAC
TTGAGGCGTAC -> TGAGGCGTACC
TGAGGCGTACC -> GAGGCGTACCT
GAGGCGTACCT -> AGGCGTACCTT
AGGCGTACCTT -> GGCGTACCTTT
GGCGTACCTTT -> GCGTACCTTTA
GCGTACCTTTA -> CGTACCTTTAA
CGTACCTTTAA -> GTACCTTTAAT
GTACCTTTAAT -> TACCTTTAATC
TACCTTTAATC -> ACCTTTAATCC
ACCTTTAATCC -> CCTTTAATCCC
CCTTTAATCCC -> CTTTAATCCCC
CTTTAATCCCC -> TTTAATCCCCC
TTTAATCCCCC -> TTAATCCCCCG
TTAATCCCCCG -> TAATCCCCCGG
TAATCCCCCGG -> AATCCCCCGGA
AATCCCCCGGA -> ATCCCCCGGAA
ATCCCCCGGAA -> TCCCCCGGAAC
TCCCCCGGAAC -> CCCCCGGAACT
CCCCCGGAACT -> CCCCGGAACTG
CCCCGGAACTG -> CCCGGAACTGG
CCCGGAACTGG -> CCGGAACTGGG
CCGGAACTGGG -> CGGAACTGGGT
CGGAACTGGGT -> GGAACTGGGTG
GGAACTGGGTG -> GAACTGGGTGA
GAACTGGGTGA -> AACTGGGTGAA
AACTGGGTGAA -> ACTGGGTGAAT
ACTGGGTGAAT -> CTGGGTGAATA
CTGGGTGAATA -> TGGGTGAATAT
TGGGTGAATAT -> GGGTGAATATC
GGGTGAATATC -> GGTGAATATCT
GGTGAATATCT -> GTGAATATCTG
GTGAATATCTG -> TGAATATCTGG
TGAATATCTGG -> GAATATCTGGA
GAATATCTGGA -> AATATCTGGAA
AATATCTGGAA -> ATATCTGGAAC
ATATCTGGAAC -> TATCTGGAACG
TATCTGGAACG -> ATCTGGAACGC
ATCTGGAACGC -> TCTGGAACGCA
TCTGGAACGCA -> CTGGAACGCAT
CTGGAACGCAT -> TGGAACGCATA
TGGAACGCATA -> GGAACGCATAA
GGAACGCATAA -> GAACGCATAAT
GAACGCATAAT -> AACGCATAATT
AACGCATAATT -> ACGCATAATTT
ACGCATAATTT -> CGCATAATTTC
CGCATAATTTC -> GCATAATTTCA
GCATAATTTCA -> CATAATTTCAT
CATAATTTCAT -> ATAATTTCATG
ATAATTTCATG -> TAATTTCATGA
TAATTTCATGA -> AATTTCATGAT
AATTTCATGAT -> ATTTCATGATG
ATTTCATGATG -> TTTCATGATGA
TTTCATGATGA -> TTCATGATGAT
TTCATGATGAT -> TCATGATGATG
TCATGATGATG -> CATGATGATGA
CATGATGATGA -> ATGATGATGAC
ATGATGATGAC -> TGATGATGACC
TGATGATGACC -> GATGATGACCC
GATGATGACCC -> ATGATGACCCG
ATGATGACCCG -> TGATGACCCGG
TGATGACCCGG -> GATGACCCGGA
GATGACCCGGA -> ATGACCCGGAA
ATGACCCGGAA -> TGACCCGGAAC
TGACCCGGAAC -> GACCCGGAACA
GACCCGGAACA -> ACCCGGAACAG
ACCCGGAACAG -> CCCGGAACAGG
CCCGGAACAGG -> CCGGAACAGGA
CCGGAACAGGA -> CGGAACAGGAT
CGGAACAGGAT -> GGAACAGGATC
GGAACAGGATC -> GAACAGGATCT
GAACAGGATCT -> AACAGGATCTG
AACAGGATCTG -> ACAGGATCTGC
ACAGGATCTGC -> CAGGATCTGCG
CAGGATCTGCG -> AGGATCTGCGT
AGGATCTGCGT -> GGATCTGCGTT
GGATCTGCGTT -> GATCTGCGTTG
GATCTGCGTTG -> ATCTGCGTTGG
ATCTGCGTTGG -> TCTGCGTTGGA
TCTGCGTTGGA -> CTGCGTTGGAT
CTGCGTTGGAT -> TGCGTTGGATG
TGCGTTGGATG -> GCGTTGGATGG
GCGTTGGATGG -> CGTTGGATGGG
CGTTGGATGGG -> GTTGGATGGGA
GTTGGATGGGA -> TTGGATGGGAC
TTGGATGGGAC -> TGGATGGGACG
TGGATGGGACG -> GGATGGGACGA
GGATGGGACGA -> GATGGGACGAA
GATGGGACGAA -> ATGGGACGAAA
ATGGGACGAAA -> TGGGACGAAAA
TGGGACGAAAA -> GGGACGAAAAT
GGGACGAAAAT -> GGACGAAAATC
GGACGAAAATC -> GACGAAAATCC
GACGAAAATCC -> ACGAAAATCCG
ACGAAAATCCG -> CGAAAATCCGT
CGAAAATCCGT -> GAAAATCCGTG
GAAAATCCGTG -> AAAATCCGTGT
AAAATCCGTGT -> AAATCCGTGTC
AAATCCGTGTC -> AATCCGTGTCT
AATCCGTGTCT -> ATCCGTGTCTA
ATCCGTGTCTA -> TCCGTGTCTAG
TCCGTGTCTAG -> CCGTGTCTAGC
CCGTGTCTAGC -> CGTGTCTAGCA
CGTGTCTAGCA -> GTGTCTAGCAC
GTGTCTAGCAC -> TGTCTAGCACC
TGTCTAGCACC -> GTCTAGCACCT
GTCTAGCACCT -> TCTAGCACCTC
TCTAGCACCTC -> CTAGCACCTCT
CTAGCACCTCT -> TAGCACCTCTC
TAGCACCTCTC -> AGCACCTCTCG
AGCACCTCTCG -> GCACCTCTCGA
GCACCTCTCGA -> CACCTCTCGAT
CACCTCTCGAT -> ACCTCTCGATG
ACCTCTCGATG -> CCTCTCGATGC
CCTCTCGATGC -> CTCTCGATGCG
CTCTCGATGCG -> TCTCGATGCGC
TCTCGATGCGC -> CTCGATGCGCA
CTCGATGCGCA -> TCGATGCGCAT
TCGATGCGCAT -> CGATGCGCATT
CGATGCGCATT -> GATGCGCATTG
GATGCGCATTG -> ATGCGCATTGG
ATGCGCATTGG -> TGCGCATTGGG
TGCGCATTGGG -> GCGCATTGGGC
GCGCATTGGGC -> CGCATTGGGCC
CGCATTGGGCC -> GCATTGGGCCA
GCATTGGGCCA -> CATTGGGCCAC
CATTGGGCCAC -> ATTGGGCCACC
ATTGGGCCACC -> TTGGGCCACCG
TTGGGCCACCG -> TGGGCCACCGT
TGGGCCACCGT -> GGGCCACCGTG
GGGCCACCGTG -> GGCCACCGTGC
GGCCACCGTGC -> GCCACCGTGCT
GCCACCGTGCT -> CCACCGTGCTA
CCACCGTGCTA -> CACCGTGCTAC
CACCGTGCTAC -> ACCGTGCTACG
ACCGTGCTACG -> CCGTGCTACGG
CCGTGCTACGG -> CGTGCTACGGC
CGTGCTACGGC -> GTGCTACGGCC
GTGCTACGGCC -> TGCTACGGCCC
TGCTACGGCCC -> GCTACGGCCCT
GCTACGGCCCT -> CTACGGCCCTT
CTACGGCCCTT -> TACGGCCCTTC
TACGGCCCTTC -> ACGGCCCTTCA
ACGGCCCTTCA -> CGGCCCTTCAT
CGGCCCTTCAT -> GGCCCTTCATT
GGCCCTTCATT -> GCCCTTCATTG
GCCCTTCATTG -> CCCTTCATTGT
CCCTTCATTGT -> CCTTCATTGTT
CCTTCATTGTT -> CTTCATTGTTC
CTTCATTGTTC -> TTCATTGTTCC
TTCATTGTTCC -> TCATTGTTCCG
TCATTGTTCCG -> CATTGTTCCGT
CATTGTTCCGT -> ATTGTTCCGTA
ATTGTTCCGTA -> TTGTTCCGTAG
TTGTTCCGTAG -> TGTTCCGTAGG
TGTTCCGTAGG -> GTTCCGTAGGC
GTTCCGTAGGC -> TTCCGTAGGCA
TTCCGTAGGCA -> TCCGTAGGCAG
TCCGTAGGCAG -> CCGTAGGCAGT
CCGTAGGCAGT -> CGTAGGCAGTA
CGTAGGCAGTA -> GTAGGCAGTAG
GTAGGCAGTAG -> TAGGCAGTAGG
TAGGCAGTAGG -> AGGCAGTAGGT
AGGCAGTAGGT -> GGCAGTAGGTG
GGCAGTAGGTG -> GCAGTAGGTGA
GCAGTAGGTGA -> CAGTAGGTGAT
CAGTAGGTGAT -> AGTAGGTGATT
AGTAGGTGATT -> GTAGGTGATTT
GTAGGTGATTT -> TAGGTGATTTT
TAGGTGATTTT -> AGGTGATTTTT
AGGTGATTTTT -> GGTGATTTTTT
GGTGATTTTTT -> GTGATTTTTTC
GTGATTTTTTC -> TGATTTTTTCC
TGATTTTTTCC -> GATTTTTTCCG
GATTTTTTCCG -> ATTTTTTCCGC
ATTTTTTCCGC -> TTTTTTCCGCC
TTTTTTCCGCC -> TTTTTCCGCCA
TTTTTCCGCCA -> TTTTCCGCCAC
TTTTCCGCCAC -> TTTCCGCCACC
TTTCCGCCACC -> TTCCGCCACCC
TTCCGCCACCC -> TCCGCCACCCC
TCCGCCACCCC -> CCGCCACCCCT
CCGCCACCCCT -> CGCCACCCCTC
CGCCACCCCTC -> GCCACCCCTCT
GCCACCCCTCT -> CCACCCCTCTT
CCACCCCTCTT -> CACCCCTCTTT
CACCCCTCTTT -> ACCCCTCTTTG
ACCCCTCTTTG -> CCCCTCTTTGC
CCCCTCTTTGC -> CCCTCTTTGCC
CCCTCTTTGCC -> CCTCTTTGCCA
CCTCTTTGCCA -> CTCTTTGCCAT
CTCTTTGCCAT -> TCTTTGCCATC
TCTTTGCCATC -> CTTTGCCATCT
CTTTGCCATCT -> TTTGCCATCTT
TTTGCCATCTT -> TTGCCATCTTA
TTGCCATCTTA -> TGCCATCTTAC
TGCCATCTTAC -> GCCATCTTACA
GCCATCTTACA -> CCATCTTACAG
CCATCTTACAG -> CATCTTACAGA
CATCTTACAGA -> ATCTTACAGAG
ATCTTACAGAG -> TCTTACAGAGA
TCTTACAGAGA -> CTTACAGAGAA
CTTACAGAGAA -> TTACAGAGAAT
TTACAGAGAAT -> TACAGAGAATA
TACAGAGAATA -> ACAGAGAATAC
ACAGAGAATAC -> CAGAGAATACA
CAGAGAATACA -> AGAGAATACAA
AGAGAATACAA -> GAGAATACAAG
GAGAATACAAG -> AGAATACAAGG
AGAATACAAGG -> GAATACAAGGA
GAATACAAGGA -> AATACAAGGAG
AATACAAGGAG -> ATACAAGGAGT
ATACAAGGAGT -> TACAAGGAGTA
TACAAGGAGTA -> ACAAGGAGTAG
ACAAGGAGTAG -> CAAGGAGTAGC
CAAGGAGTAGC -> AAGGAGTAGCG
AAGGAGTAGCG -> AGGAGTAGCGA
AGGAGTAGCGA -> GGAGTAGCGAA
GGAGTAGCGAA -> GAGTAGCGAAG
GAGTAGCGAAG -> AGTAGCGAAGC
AGTAGCGAAGC -> GTAGCGAAGCT
GTAGCGAAGCT -> TAGCGAAGCTG
TAGCGAAGCTG -> AGCGAAGCTGT
AGCGAAGCTGT -> GCGAAGCTGTC
GCGAAGCTGTC -> CGAAGCTGTCC
CGAAGCTGTCC -> GAAGCTGTCCA
GAAGCTGTCCA -> AAGCTGTCCAG
AAGCTGTCCAG -> AGCTGTCCAGA
AGCTGTCCAGA -> GCTGTCCAGAT
GCTGTCCAGAT -> CTGTCCAGATC
CTGTCCAGATC -> TGTCCAGATCG
TGTCCAGATCG -> GTCCAGATCGC
GTCCAGATCGC -> TCCAGATCGCG
TCCAGATCGCG -> CCAGATCGCGA
CCAGATCGCGA -> CAGATCGCGAA
CAGATCGCGAA -> AGATCGCGAAC
AGATCGCGAAC -> GATCGCGAACA
GATCGCGAACA -> ATCGCGAACAT
ATCGCGAACAT -> TCGCGAACATA
TCGCGAACATA -> CGCGAACATAG
CGCGAACATAG -> GCGAACATAGT
GCGAACATAGT -> CGAACATAGTA
CGAACATAGTA -> GAACATAGTAA
GAACATAGTAA -> AACATAGTAAT
AACATAGTAAT -> ACATAGTAATC
ACATAGTAATC -> CATAGTAATCT
CATAGTAATCT -> ATAGTAATCTA
ATAGTAATCTA -> TAGTAATCTAT
TAGTAATCTAT -> AGTAATCTATG
AGTAATCTATG -> GTAATCTATGC
GTAATCTATGC -> TAATCTATGCG
TAATCTATGCG -> AATCTATGCGA
AATCTATGCGA -> ATCTATGCGAG
ATCTATGCGAG -> TCTATGCGAGC
TCTATGCGAGC -> CTATGCGAGCT
CTATGCGAGCT -> TATGCGAGCTC
TATGCGAGCTC -> ATGCGAGCTCG
ATGCGAGCTCG -> TGCGAGCTCGT
TGCGAGCTCGT -> GCGAGCTCGTG
GCGAGCTCGTG -> CGAGCTCGTGG
CGAGCTCGTGG -> GAGCTCGTGGG
GAGCTCGTGGG -> AGCTCGTGGGC
AGCTCGTGGGC -> GCTCGTGGGCT
GCTCGTGGGCT -> CTCGTGGGCTA
CTCGTGGGCTA -> TCGTGGGCTAC
TCGTGGGCTAC -> CGTGGGCTACA
CGTGGGCTACA -> GTGGGCTACAA
GTGGGCTACAA -> TGGGCTACAAG
TGGGCTACAAG -> GGGCTACAAGG
GGGCTACAAGG -> GGCTACAAGGG
GGCTACAAGGG -> GCTACAAGGGT
GCTACAAGGGT -> CTACAAGGGTC
CTACAAGGGTC -> TACAAGGGTCA
TACAAGGGTCA -> ACAAGGGTCAC
ACAAGGGTCAC -> CAAGGGTCACC
CAAGGGTCACC -> AAGGGTCACCT
AAGGGTCACCT -> AGGGTCACCTG
AGGGTCACCTG -> GGGTCACCTGC
GGGTCACCTGC -> GGTCACCTGCT
GGTCACCTGCT -> GTCACCTGCTA
GTCACCTGCTA -> TCACCTGCTAG
TCACCTGCTAG -> CACCTGCTAGA
CACCTGCTAGA -> ACCTGCTAGAA
ACCTGCTAGAA -> CCTGCTAGAAT
CCTGCTAGAAT -> CTGCTAGAATC
CTGCTAGAATC -> TGCTAGAATCG
TGCTAGAATCG -> GCTAGAATCGA
GCTAGAATCGA -> CTAGAATCGAC
CTAGAATCGAC -> TAGAATCGACT
TAGAATCGACT -> AGAATCGACTG
AGAATCGACTG -> GAATCGACTGA
GAATCGACTGA -> AATCGACTGAG
AATCGACTGAG -> ATCGACTGAGG
ATCGACTGAGG -> TCGACTGAGGG
TCGACTGAGGG -> CGACTGAGGGA
CGACTGAGGGA -> GACTGAGGGAG
GACTGAGGGAG -> ACTGAGGGAGT
ACTGAGGGAGT -> CTGAGGGAGTG
CTGAGGGAGTG -> TGAGGGAGTGC
TGAGGGAGTGC -> GAGGGAGTGCA
GAGGGAGTGCA -> AGGGAGTGCAG
AGGGAGTGCAG -> GGGAGTGCAGC
GGGAGTGCAGC -> GGAGTGCAGCA
GGAGTGCAGCA -> GAGTGCAGCAG
GAGTGCAGCAG -> AGTGCAGCAGG
AGTGCAGCAGG -> GTGCAGCAGGT
GTGCAGCAGGT -> TGCAGCAGGTC
TGCAGCAGGTC -> GCAGCAGGTCC
GCAGCAGGTCC -> CAGCAGGTCCG
CAGCAGGTCCG -> AGCAGGTCCGT
AGCAGGTCCGT -> GCAGGTCCGTT
GCAGGTCCGTT -> CAGGTCCGTTA
CAGGTCCGTTA -> AGGTCCGTTAC
AGGTCCGTTAC -> GGTCCGTTACT
GGTCCGTTACT -> GTCCGTTACTT
GTCCGTTACTT -> TCCGTTACTTG
TCCGTTACTTG -> CCGTTACTTGT
CCGTTACTTGT -> CGTTACTTGTT
CGTTACTTGTT -> GTTACTTGTTT
GTTACTTGTTT -> TTACTTGTTTG
TTACTTGTTTG -> TACTTGTTTGG
TACTTGTTTGG -> ACTTGTTTGGA
ACTTGTTTGGA -> CTTGTTTGGAG
CTTGTTTGGAG -> TTGTTTGGAGA
TTGTTTGGAGA -> TGTTTGGAGAG
TGTTTGGAGAG -> GTTTGGAGAGG
GTTTGGAGAGG -> TTTGGAGAGGT
TTTGGAGAGGT -> TTGGAGAGGTA
TTGGAGAGGTA -> TGGAGAGGTAG
TGGAGAGGTAG -> GGAGAGGTAGC
GGAGAGGTAGC -> GAGAGGTAGCT
GAGAGGTAGCT -> AGAGGTAGCTA
AGAGGTAGCTA -> GAGGTAGCTAG
GAGGTAGCTAG -> AGGTAGCTAGT
AGGTAGCTAGT -> GGTAGCTAGTC
GGTAGCTAGTC -> GTAGCTAGTCG
GTAGCTAGTCG -> TAGCTAGTCGG
TAGCTAGTCGG -> AGCTAGTCGGG
AGCTAGTCGGG -> GCTAGTCGGGT
GCTAGTCGGGT -> CTAGTCGGGTT
CTAGTCGGGTT -> TAGTCGGGTTC
TAGTCGGGTTC -> AGTCGGGTTCA
AGTCGGGTTCA -> GTCGGGTTCAC
GTCGGGTTCAC -> TCGGGTTCACC
TCGGGTTCACC -> CGGGTTCACCA
CGGGTTCACCA -> GGGTTCACCAG
GGGTTCACCAG -> GGTTCACCAGG
GGTTCACCAGG -> GTTCACCAGGC
GTTCACCAGGC -> TTCACCAGGCC
TTCACCAGGCC -> TCACCAGGCCC
TCACCAGGCCC -> CACCAGGCCCA
CACCAGGCCCA -> ACCAGGCCCAC
ACCAGGCCCAC -> CCAGGCCCACC
CCAGGCCCACC -> CAGGCCCACCG
CAGGCCCACCG -> AGGCCCACCGA
AGGCCCACCGA -> GGCCCACCGAG
GGCCCACCGAG -> GCCCACCGAGG
GCCCACCGAGG -> CCCACCGAGGA
CCCACCGAGGA -> CCACCGAGGAA
CCACCGAGGAA -> CACCGAGGAAA
CACCGAGGAAA -> ACCGAGGAAAT
ACCGAGGAAAT -> CCGAGGAAATT
CCGAGGAAATT -> CGAGGAAATTA
CGAGGAAATTA -> GAGGAAATTAG
GAGGAAATTAG -> AGGAAATTAGA
AGGAAATTAGA -> GGAAATTAGAC
GGAAATTAGAC -> GAAATTAGACA
GAAATTAGACA -> AAATTAGACAA
AAATTAGACAA -> AATTAGACAAG
AATTAGACAAG -> ATTAGACAAGC
ATTAGACAAGC -> TTAGACAAGCT
TTAGACAAGCT -> TAGACAAGCTA
TAGACAAGCTA -> AGACAAGCTAG
AGACAAGCTAG -> GACAAGCTAGG
GACAAGCTAGG -> ACAAGCTAGGA
ACAAGCTAGGA -> CAAGCTAGGAA
CAAGCTAGGAA -> AAGCTAGGAAC
AAGCTAGGAAC -> AGCTAGGAACA
AGCTAGGAACA -> GCTAGGAACAA
GCTAGGAACAA -> CTAGGAACAAA
CTAGGAACAAA -> TAGGAACAAAC
TAGGAACAAAC -> AGGAACAAACG
AGGAACAAACG -> GGAACAAACGA
GGAACAAACGA -> GAACAAACGAG
GAACAAACGAG -> AACAAACGAGA
AACAAACGAGA -> ACAAACGAGAA
ACAAACGAGAA -> CAAACGAGAAT
CAAACGAGAAT -> AAACGAGAATC
AAACGAGAATC -> AACGAGAATCG
AACGAGAATCG -> ACGAGAATCGT
ACGAGAATCGT -> CGAGAATCGTG
CGAGAATCGTG -> GAGAATCGTGT
GAGAATCGTGT -> AGAATCGTGTT
AGAATCGTGTT -> GAATCGTGTTT
GAATCGTGTTT -> AATCGTGTTTT
AATCGTGTTTT -> ATCGTGTTTTT
ATCGTGTTTTT -> TCGTGTTTTTT
TCGTGTTTTTT -> CGTGTTTTTTG
CGTGTTTTTTG -> GTGTTTTTTGT
GTGTTTTTTGT -> TGTTTTTTGTT
TGTTTTTTGTT -> GTTTTTTGTTC
GTTTTTTGTTC -> TTTTTTGTTCT
TTTTTTGTTCT -> TTTTTGTTCTG
TTTTTGTTCTG -> TTTTGTTCTGG
TTTTGTTCTGG -> TTTGTTCTGGC
TTTGTTCTGGC -> TTGTTCTGGCC
TTGTTCTGGCC -> TGTTCTGGCCT
TGTTCTGGCCT -> GTTCTGGCCTT
GTTCTGGCCTT -> TTCTGGCCTTT
TTCTGGCCTTT -> TCTGGCCTTTA
TCTGGCCTTTA -> CTGGCCTTTAC
CTGGCCTTTAC -> TGGCCTTTACA
TGGCCTTTACA -> GGCCTTTACAT
GGCCTTTACAT -> GCCTTTACATG
GCCTTTACATG -> CCTTTACATGA
CCTTTACATGA -> CTTTACATGAA
CTTTACATGAA -> TTTACATGAAA
TTTACATGAAA -> TTACATGAAAG
TTACATGAAAG -> TACATGAAAGC
TACATGAAAGC -> ACATGAAAGCT
ACATGAAAGCT -> CATGAAAGCTG
CATGAAAGCTG -> ATGAAAGCTGC
ATGAAAGCTGC -> TGAAAGCTGCT
TGAAAGCTGCT -> GAAAGCTGCTT
GAAAGCTGCTT -> AAAGCTGCTTC
AAAGCTGCTTC -> AAGCTGCTTCC
AAGCTGCTTCC -> AGCTGCTTCCC
AGCTGCTTCCC -> GCTGCTTCCCC
GCTGCTTCCCC -> CTGCTTCCCCT
CTGCTTCCCCT -> TGCTTCCCCTG
TGCTTCCCCTG -> GCTTCCCCTGA
GCTTCCCCTGA -> CTTCCCCTGAT
CTTCCCCTGAT -> TTCCCCTGATT
TTCCCCTGATT -> TCCCCTGATTA
TCCCCTGATTA -> CCCCTGATTAG
CCCCTGATTAG -> CCCTGATTAGC
CCCTGATTAGC -> CCTGATTAGCG
CCTGATTAGCG -> CTGATTAGCGT
CTGATTAGCGT -> TGATTAGCGTT
TGATTAGCGTT -> GATTAGCGTTA
GATTAGCGTTA -> ATTAGCGTTAC
ATTAGCGTTAC -> TTAGCGTTACG
TTAGCGTTACG -> TAGCGTTACGA
TAGCGTTACGA -> AGCGTTACGAC
AGCGTTACGAC -> GCGTTACGACC
GCGTTACGACC -> CGTTACGACCC
CGTTACGACCC -> GTTACGACCCC
GTTACGACCCC -> TTACGACCCCC
TTACGACCCCC -> TACGACCCCCC
TACGACCCCCC -> ACGACCCCCCC
ACGACCCCCCC -> CGACCCCCCCG
CGACCCCCCCG -> GACCCCCCCGG
GACCCCCCCGG -> ACCCCCCCGGG
ACCCCCCCGGG -> CCCCCCCGGGG
CCCCCCCGGGG -> CCCCCCGGGGC
CCCCCCGGGGC -> CCCCCGGGGCG
CCCCCGGGGCG -> CCCCGGGGCGA
CCCCGGGGCGA -> CCCGGGGCGAG
CCCGGGGCGAG -> CCGGGGCGAGT
CCGGGGCGAGT -> CGGGGCGAGTG
CGGGGCGAGTG -> GGGGCGAGTGC
GGGGCGAGTGC -> GGGCGAGTGCG
GGGCGAGTGCG -> GGCGAGTGCGG
GGCGAGTGCGG -> GCGAGTGCGGT
GCGAGTGCGGT -> CGAGTGCGGTA
CGAGTGCGGTA -> GAGTGCGGTAA
GAGTGCGGTAA -> AGTGCGGTAAG
AGTGCGGTAAG -> GTGCGGTAAGT
GTGCGGTAAGT -> TGCGGTAAGTT
TGCGGTAAGTT -> GCGGTAAGTTC
GCGGTAAGTTC -> CGGTAAGTTCA
CGGTAAGTTCA -> GGTAAGTTCAT
GGTAAGTTCAT -> GTAAGTTCATT
GTAAGTTCATT -> TAAGTTCATTG
TAAGTTCATTG -> AAGTTCATTGC
AAGTTCATTGC -> AGTTCATTGCT
AGTTCATTGCT -> GTTCATTGCTC
GTTCATTGCTC -> TTCATTGCTCT
TTCATTGCTCT -> TCATTGCTCTA
TCATTGCTCTA -> CATTGCTCTAG
CATTGCTCTAG -> ATTGCTCTAGG
ATTGCTCTAGG -> TTGCTCTAGGC
TTGCTCTAGGC -> TGCTCTAGGCA
TGCTCTAGGCA -> GCTCTAGGCAT
GCTCTAGGCAT -> CTCTAGGCATT
CTCTAGGCATT -> TCTAGGCATTG
TCTAGGCATTG -> CTAGGCATTGT
CTAGGCATTGT -> TAGGCATTGTT
TAGGCATTGTT -> AGGCATTGTTT
AGGCATTGTTT -> GGCATTGTTTG
GGCATTGTTTG -> GCATTGTTTGT
GCATTGTTTGT -> CATTGTTTGTT
CATTGTTTGTT -> ATTGTTTGTTA
ATTGTTTGTTA -> TTGTTTGTTAC
TTGTTTGTTAC -> TGTTTGTTACC
TGTTTGTTACC -> GTTTGTTACCT
GTTTGTTACCT -> TTTGTTACCTT
TTTGTTACCTT -> TTGTTACCTTA
TTGTTACCTTA -> TGTTACCTTAC
TGTTACCTTAC -> GTTACCTTACA
GTTACCTTACA -> TTACCTTACAG
TTACCTTACAG -> TACCTTACAGG
TACCTTACAGG -> ACCTTACAGGG
ACCTTACAGGG -> CCTTACAGGGT
CCTTACAGGGT -> CTTACAGGGTC
CTTACAGGGTC -> TTACAGGGTCT
TTACAGGGTCT -> TACAGGGTCTC
TACAGGGTCTC -> ACAGGGTCTCG
ACAGGGTCTCG -> CAGGGTCTCGA
CAGGGTCTCGA -> AGGGTCTCGAG
AGGGTCTCGAG -> GGGTCTCGAGC
GGGTCTCGAGC -> GGTCTCGAGCA
GGTCTCGAGCA -> GTCTCGAGCAA
GTCTCGAGCAA -> TCTCGAGCAAA
TCTCGAGCAAA -> CTCGAGCAAAA
CTCGAGCAAAA -> TCGAGCAAAAT
TCGAGCAAAAT -> CGAGCAAAATT
CGAGCAAAATT -> GAGCAAAATTC
GAGCAAAATTC -> AGCAAAATTCC
AGCAAAATTCC -> GCAAAATTCCA
GCAAAATTCCA -> CAAAATTCCAC
CAAAATTCCAC -> AAAATTCCACG
AAAATTCCACG -> AAATTCCACGA
AAATTCCACGA -> AATTCCACGAG
AATTCCACGAG -> ATTCCACGAGT
ATTCCACGAGT -> TTCCACGAGTT
TTCCACGAGTT -> TCCACGAGTTT
TCCACGAGTTT -> CCACGAGTTTA
CCACGAGTTTA -> CACGAGTTTAT
CACGAGTTTAT -> ACGAGTTTATA
ACGAGTTTATA -> CGAGTTTATAT
CGAGTTTATAT -> GAGTTTATATT
GAGTTTATATT -> AGTTTATATTA
AGTTTATATTA -> GTTTATATTAG
GTTTATATTAG -> TTTATATTAGG
TTTATATTAGG -> TTATATTAGGT
TTATATTAGGT -> TATATTAGGTA
TATATTAGGTA -> ATATTAGGTAA
ATATTAGGTAA -> TATTAGGTAAC
TATTAGGTAAC -> ATTAGGTAACG
ATTAGGTAACG -> TTAGGTAACGG
TTAGGTAACGG -> TAGGTAACGGA
TAGGTAACGGA -> AGGTAACGGAA
AGGTAACGGAA -> GGTAACGGAAT
GGTAACGGAAT -> GTAACGGAATA
GTAACGGAATA -> TAACGGAATAG
TAACGGAATAG -> AACGGAATAGG
AACGGAATAGG -> ACGGAATAGGA
ACGGAATAGGA -> CGGAATAGGAT
CGGAATAGGAT -> GGAATAGGATC
GGAATAGGATC -> GAATAGGATCG
GAATAGGATCG -> AATAGGATCGT
AATAGGATCGT -> ATAGGATCGTA
ATAGGATCGTA -> TAGGATCGTAG
TAGGATCGTAG -> AGGATCGTAGT
AGGATCGTAGT -> GGATCGTAGTT
GGATCGTAGTT -> GATCGTAGTTA
GATCGTAGTTA -> ATCGTAGTTAA
ATCGTAGTTAA -> TCGTAGTTAAG
TCGTAGTTAAG -> CGTAGTTAAGG
CGTAGTTAAGG -> GTAGTTAAGGG
GTAGTTAAGGG -> TAGTTAAGGGG
TAGTTAAGGGG -> AGTTAAGGGGA
AGTTAAGGGGA -> GTTAAGGGGAG
GTTAAGGGGAG -> TTAAGGGGAGG
TTAAGGGGAGG -> TAAGGGGAGGT
TAAGGGGAGGT -> AAGGGGAGGTT
AAGGGGAGGTT -> AGGGGAGGTTT
AGGGGAGGTTT -> GGGGAGGTTTA
GGGGAGGTTTA -> GGGAGGTTTAT
GGGAGGTTTAT -> GGAGGTTTATA
GGAGGTTTATA -> GAGGTTTATAC
GAGGTTTATAC -> AGGTTTATACG
AGGTTTATACG -> GGTTTATACGT
GGTTTATACGT -> GTTTATACGTC
GTTTATACGTC -> TTTATACGTCT
TTTATACGTCT -> TTATACGTCTG
TTATACGTCTG -> TATACGTCTGA
TATACGTCTGA -> ATACGTCTGAT
ATACGTCTGAT -> TACGTCTGATC
TACGTCTGATC -> ACGTCTGATCG
ACGTCTGATCG -> CGTCTGATCGG
CGTCTGATCGG -> GTCTGATCGGG
GTCTGATCGGG -> TCTGATCGGGT
TCTGATCGGGT -> CTGATCGGGTG
CTGATCGGGTG -> TGATCGGGTGC
TGATCGGGTGC -> GATCGGGTGCC
GATCGGGTGCC -> ATCGGGTGCCT
ATCGGGTGCCT -> TCGGGTGCCTT
TCGGGTGCCTT -> CGGGTGCCTTA
CGGGTGCCTTA -> GGGTGCCTTAC
GGGTGCCTTAC -> GGTGCCTTACT
GGTGCCTTACT -> GTGCCTTACTC
GTGCCTTACTC -> TGCCTTACTCG
TGCCTTACTCG -> GCCTTACTCGG
GCCTTACTCGG -> CCTTACTCGGT
CCTTACTCGGT -> CTTACTCGGTG
CTTACTCGGTG -> TTACTCGGTGG
TTACTCGGTGG -> TACTCGGTGGC
TACTCGGTGGC -> ACTCGGTGGCA
ACTCGGTGGCA -> CTCGGTGGCAA
CTCGGTGGCAA -> TCGGTGGCAAG
TCGGTGGCAAG -> CGGTGGCAAGG
CGGTGGCAAGG -> GGTGGCAAGGC
GGTGGCAAGGC -> GTGGCAAGGCC
GTGGCAAGGCC -> TGGCAAGGCCA
TGGCAAGGCCA -> GGCAAGGCCAT
GGCAAGGCCAT -> GCAAGGCCATG
GCAAGGCCATG -> CAAGGCCATGT
CAAGGCCATGT -> AAGGCCATGTT
AAGGCCATGTT -> AGGCCATGTTA
AGGCCATGTTA -> GGCCATGTTAC
GGCCATGTTAC -> GCCATGTTACT
GCCATGTTACT -> CCATGTTACTA
CCATGTTACTA -> CATGTTACTAT
CATGTTACTAT -> ATGTTACTATT
ATGTTACTATT -> TGTTACTATTC
TGTTACTATTC -> GTTACTATTCC
GTTACTATTCC -> TTACTATTCCA
TTACTATTCCA -> TACTATTCCAG
TACTATTCCAG -> ACTATTCCAGT
ACTATTCCAGT -> CTATTCCAGTA
CTATTCCAGTA -> TATTCCAGTAA
TATTCCAGTAA -> ATTCCAGTAAG
ATTCCAGTAAG -> TTCCAGTAAGC
TTCCAGTAAGC -> TCCAGTAAGCG
TCCAGTAAGCG -> CCAGTAAGCGA
CCAGTAAGCGA -> CAGTAAGCGAG
CAGTAAGCGAG -> AGTAAGCGAGA
AGTAAGCGAGA -> GTAAGCGAGAA
GTAAGCGAGAA -> TAAGCGAGAAC
TAAGCGAGAAC -> AAGCGAGAACT
AAGCGAGAACT -> AGCGAGAACTT
AGCGAGAACTT -> GCGAGAACTTA
GCGAGAACTTA -> CGAGAACTTAA
CGAGAACTTAA -> GAGAACTTAAT
GAGAACTTAAT -> AGAACTTAATT
AGAACTTAATT -> GAACTTAATTA
GAACTTAATTA -> AACTTAATTAG
AACTTAATTAG -> ACTTAATTAGT
ACTTAATTAGT -> CTTAATTAGTC
CTTAATTAGTC -> TTAATTAGTCC
TTAATTAGTCC -> TAATTAGTCCG
TAATTAGTCCG -> AATTAGTCCGA
AATTAGTCCGA -> ATTAGTCCGAG
ATTAGTCCGAG -> TTAGTCCGAGT
TTAGTCCGAGT -> TAGTCCGAGTA
TAGTCCGAGTA -> AGTCCGAGTAA
AGTCCGAGTAA -> GTCCGAGTAAT
GTCCGAGTAAT -> TCCGAGTAATC
TCCGAGTAATC -> CCGAGTAATCT
CCGAGTAATCT -> CGAGTAATCTA
CGAGTAATCTA -> GAGTAATCTAT
GAGTAATCTAT -> AGTAATCTATC
AGTAATCTATC -> GTAATCTATCC
GTAATCTATCC -> TAATCTATCCA
TAATCTATCCA -> AATCTATCCAT
AATCTATCCAT -> ATCTATCCATG
ATCTATCCATG -> TCTATCCATGT
TCTATCCATGT -> CTATCCATGTC
CTATCCATGTC -> TATCCATGTCA
TATCCATGTCA -> ATCCATGTCAT
ATCCATGTCAT -> TCCATGTCATT
TCCATGTCATT -> CCATGTCATTT
CCATGTCATTT -> CATGTCATTTA
CATGTCATTTA -> ATGTCATTTAC
ATGTCATTTAC -> TGTCATTTACG
TGTCATTTACG -> GTCATTTACGA
GTCATTTACGA -> TCATTTACGAG
TCATTTACGAG -> CATTTACGAGT
CATTTACGAGT -> ATTTACGAGTT
ATTTACGAGTT -> TTTACGAGTTC
TTTACGAGTTC -> TTACGAGTTCC
TTACGAGTTCC -> TACGAGTTCCG
TACGAGTTCCG -> ACGAGTTCCGG
ACGAGTTCCGG -> CGAGTTCCGGT
CGAGTTCCGGT -> GAGTTCCGGTA
GAGTTCCGGTA -> AGTTCCGGTAA
AGTTCCGGTAA -> GTTCCGGTAAT
GTTCCGGTAAT -> TTCCGGTAATG
TTCCGGTAATG -> TCCGGTAATGA
TCCGGTAATGA -> CCGGTAATGAA
CCGGTAATGAA -> CGGTAATGAAC
CGGTAATGAAC -> GGTAATGAACC
GGTAATGAACC -> GTAATGAACCC
GTAATGAACCC -> TAATGAACCCT
TAATGAACCCT -> AATGAACCCTA
AATGAACCCTA -> ATGAACCCTAT
ATGAACCCTAT -> TGAACCCTATC
TGAACCCTATC -> GAACCCTATCC
GAACCCTATCC -> AACCCTATCCT
AACCCTATCCT -> ACCCTATCCTA
ACCCTATCCTA -> CCCTATCCTAG
CCCTATCCTAG -> CCTATCCTAGA
CCTATCCTAGA -> CTATCCTAGAG
CTATCCTAGAG -> TATCCTAGAGA
TATCCTAGAGA -> ATCCTAGAGAG
ATCCTAGAGAG -> TCCTAGAGAGC
TCCTAGAGAGC -> CCTAGAGAGCG
CCTAGAGAGCG -> CTAGAGAGCGT
CTAGAGAGCGT -> TAGAGAGCGTG
TAGAGAGCGTG -> AGAGAGCGTGA
AGAGAGCGTGA -> GAGAGCGTGAT
GAGAGCGTGAT -> AGAGCGTGATG
AGAGCGTGATG -> GAGCGTGATGG
GAGCGTGATGG -> AGCGTGATGGA
AGCGTGATGGA -> GCGTGATGGAT
GCGTGATGGAT -> CGTGATGGATG
CGTGATGGATG -> GTGATGGATGG
GTGATGGATGG -> TGATGGATGGA
TGATGGATGGA -> GATGGATGGAA
GATGGATGGAA -> ATGGATGGAAG
ATGGATGGAAG -> TGGATGGAAGG
TGGATGGAAGG -> GGATGGAAGGT
GGATGGAAGGT -> GATGGAAGGTG
GATGGAAGGTG -> ATGGAAGGTGA
ATGGAAGGTGA -> TGGAAGGTGAC
TGGAAGGTGAC -> GGAAGGTGACG
GGAAGGTGACG -> GAAGGTGACGG
GAAGGTGACGG -> AAGGTGACGGC
AAGGTGACGGC -> AGGTGACGGCT
AGGTGACGGCT -> GGTGACGGCTA
GGTGACGGCTA -> GTGACGGCTAC
GTGACGGCTAC -> TGACGGCTACT
TGACGGCTACT -> GACGGCTACTC
GACGGCTACTC -> ACGGCTACTCT
ACGGCTACTCT -> CGGCTACTCTA
CGGCTACTCTA -> GGCTACTCTAC
GGCTACTCTAC -> GCTACTCTACT
GCTACTCTACT -> CTACTCTACTA
CTACTCTACTA -> TACTCTACTAA
TACTCTACTAA -> ACTCTACTAAA
ACTCTACTAAA -> CTCTACTAAAA
CTCTACTAAAA -> TCTACTAAAAC
TCTACTAAAAC -> CTACTAAAACG
CTACTAAAACG -> TACTAAAACGC
TACTAAAACGC -> ACTAAAACGCC
ACTAAAACGCC -> CTAAAACGCCT
CTAAAACGCCT -> TAAAACGCCTA
TAAAACGCCTA -> AAAACGCCTAG
AAAACGCCTAG -> AAACGCCTAGC
AAACGCCTAGC -> AACGCCTAGCC
AACGCCTAGCC -> ACGCCTAGCCT
ACGCCTAGCCT -> CGCCTAGCCTT
CGCCTAGCCTT -> GCCTAGCCTTT
GCCTAGCCTTT -> CCTAGCCTTTC
CCTAGCCTTTC -> CTAGCCTTTCG
CTAGCCTTTCG -> TAGCCTTTCGG
TAGCCTTTCGG -> AGCCTTTCGGC
AGCCTTTCGGC -> GCCTTTCGGCG
GCCTTTCGGCG -> CCTTTCGGCGA
CCTTTCGGCGA -> CTTTCGGCGAT
CTTTCGGCGAT -> TTTCGGCGATG
TTTCGGCGATG -> TTCGGCGATGC
TTCGGCGATGC -> TCGGCGATGCG
TCGGCGATGCG -> CGGCGATGCGA
CGGCGATGCGA -> GGCGATGCGAA
GGCGATGCGAA -> GCGATGCGAAA
GCGATGCGAAA -> CGATGCGAAAG
CGATGCGAAAG -> GATGCGAAAGC
GATGCGAAAGC -> ATGCGAAAGCG
ATGCGAAAGCG -> TGCGAAAGCGC
TGCGAAAGCGC -> GCGAAAGCGCC
GCGAAAGCGCC -> CGAAAGCGCCG
CGAAAGCGCCG -> GAAAGCGCCGT
GAAAGCGCCGT -> AAAGCGCCGTT
AAAGCGCCGTT -> AAGCGCCGTTC
AAGCGCCGTTC -> AGCGCCGTTCG
AGCGCCGTTCG -> GCGCCGTTCGT
GCGCCGTTCGT -> CGCCGTTCGTA
CGCCGTTCGTA -> GCCGTTCGTAC
GCCGTTCGTAC -> CCGTTCGTACG
CCGTTCGTACG -> CGTTCGTACGT
CGTTCGTACGT -> GTTCGTACGTG
GTTCGTACGTG -> TTCGTACGTGA
TTCGTACGTGA -> TCGTACGTGAA
TCGTACGTGAA -> CGTACGTGAAG
CGTACGTGAAG -> GTACGTGAAGA
GTACGTGAAGA -> TACGTGAAGAG
TACGTGAAGAG -> ACGTGAAGAGA
ACGTGAAGAGA -> CGTGAAGAGAG
CGTGAAGAGAG -> GTGAAGAGAGC
GTGAAGAGAGC -> TGAAGAGAGCA
TGAAGAGAGCA -> GAAGAGAGCAG
GAAGAGAGCAG -> AAGAGAGCAGT
AAGAGAGCAGT -> AGAGAGCAGTG
AGAGAGCAGTG -> GAGAGCAGTGG
GAGAGCAGTGG -> AGAGCAGTGGA
AGAGCAGTGGA -> GAGCAGTGGAC
GAGCAGTGGAC -> AGCAGTGGACT
AGCAGTGGACT -> GCAGTGGACTG
GCAGTGGACTG -> CAGTGGACTGG
CAGTGGACTGG -> AGTGGACTGGT
AGTGGACTGGT -> GTGGACTGGTT
GTGGACTGGTT -> TGGACTGGTTC
TGGACTGGTTC -> GGACTGGTTCC
GGACTGGTTCC -> GACTGGTTCCT
GACTGGTTCCT -> ACTGGTTCCTG
ACTGGTTCCTG -> CTGGTTCCTGC
CTGGTTCCTGC -> TGGTTCCTGCA
TGGTTCCTGCA -> GGTTCCTGCAA
GGTTCCTGCAA -> GTTCCTGCAAG
GTTCCTGCAAG -> TTCCTGCAAGT
TTCCTGCAAGT -> TCCTGCAAGTT
TCCTGCAAGTT -> CCTGCAAGTTC
CCTGCAAGTTC -> CTGCAAGTTCT
CTGCAAGTTCT -> TGCAAGTTCTG
TGCAAGTTCTG -> GCAAGTTCTGT
GCAAGTTCTGT -> CAAGTTCTGTC
CAAGTTCTGTC -> AAGTTCTGTCC
AAGTTCTGTCC -> AGTTCTGTCCC
AGTTCTGTCCC -> GTTCTGTCCCC
GTTCTGTCCCC -> TTCTGTCCCCC
TTCTGTCCCCC -> TCTGTCCCCCG
TCTGTCCCCCG -> CTGTCCCCCGC
CTGTCCCCCGC -> TGTCCCCCGCG
TGTCCCCCGCG -> GTCCCCCGCGT
GTCCCCCGCGT -> TCCCCCGCGTG
TCCCCCGCGTG -> CCCCCGCGTGC
CCCCCGCGTGC -> CCCCGCGTGCT
CCCCGCGTGCT -> CCCGCGTGCTG
CCCGCGTGCTG -> CCGCGTGCTGA
CCGCGTGCTGA -> CGCGTGCTGAG
CGCGTGCTGAG -> GCGTGCTGAGG
GCGTGCTGAGG -> CGTGCTGAGGT
CGTGCTGAGGT -> GTGCTGAGGTA
GTGCTGAGGTA -> TGCTGAGGTAG
TGCTGAGGTAG -> GCTGAGGTAGG
GCTGAGGTAGG -> CTGAGGTAGGC
CTGAGGTAGGC -> TGAGGTAGGCA
TGAGGTAGGCA -> GAGGTAGGCAA
GAGGTAGGCAA -> AGGTAGGCAAG
AGGTAGGCAAG -> GGTAGGCAAGA
GGTAGGCAAGA -> GTAGGCAAGAT
GTAGGCAAGAT -> TAGGCAAGATC
TAGGCAAGATC -> AGGCAAGATCG
AGGCAAGATCG -> GGCAAGATCGC
GGCAAGATCGC -> GCAAGATCGCA
GCAAGATCGCA -> CAAGATCGCAG
CAAGATCGCAG -> AAGATCGCAGA
AAGATCGCAGA -> AGATCGCAGAT
AGATCGCAGAT -> GATCGCAGATT
GATCGCAGATT -> ATCGCAGATTC
ATCGCAGATTC -> TCGCAGATTCA
TCGCAGATTCA -> CGCAGATTCAA
CGCAGATTCAA -> GCAGATTCAAG
GCAGATTCAAG -> CAGATTCAAGC
CAGATTCAAGC -> AGATTCAAGCT
AGATTCAAGCT -> GATTCAAGCTT
GATTCAAGCTT -> ATTCAAGCTTC
ATTCAAGCTTC -> TTCAAGCTTCG
TTCAAGCTTCG -> TCAAGCTTCGA
TCAAGCTTCGA -> CAAGCTTCGAC
CAAGCTTCGAC -> AAGCTTCGACC
AAGCTTCGACC -> AGCTTCGACCT
AGCTTCGACCT -> GCTTCGACCTC
GCTTCGACCTC -> CTTCGACCTCG
CTTCGACCTCG -> TTCGACCTCGG
TTCGACCTCGG -> TCGACCTCGGC
TCGACCTCGGC -> CGACCTCGGCG
CGACCTCGGCG -> GACCTCGGCGG
GACCTCGGCGG -> ACCTCGGCGGA
ACCTCGGCGGA -> CCTCGGCGGAC
CCTCGGCGGAC -> CTCGGCGGACA
CTCGGCGGACA -> TCGGCGGACAC
TCGGCGGACAC -> CGGCGGACACC
CGGCGGACACC -> GGCGGACACCA
GGCGGACACCA -> GCGGACACCAT
GCGGACACCAT -> CGGACACCATC
CGGACACCATC -> GGACACCATCC
GGACACCATCC -> GACACCATCCC
GACACCATCCC -> ACACCATCCCA
ACACCATCCCA -> CACCATCCCAA
CACCATCCCAA -> ACCATCCCAAT
ACCATCCCAAT -> CCATCCCAATC
CCATCCCAATC -> CATCCCAATCT
CATCCCAATCT -> ATCCCAATCTG
ATCCCAATCTG -> TCCCAATCTGT
TCCCAATCTGT -> CCCAATCTGTA
CCCAATCTGTA -> CCAATCTGTAA
CCAATCTGTAA -> CAATCTGTAAA
CAATCTGTAAA -> AATCTGTAAAC
AATCTGTAAAC -> ATCTGTAAACT
ATCTGTAAACT -> TCTGTAAACTA
TCTGTAAACTA -> CTGTAAACTAT
CTGTAAACTAT -> TGTAAACTATG
TGTAAACTATG -> GTAAACTATGG
GTAAACTATGG -> TAAACTATGGT
TAAACTATGGT -> AAACTATGGTG
AAACTATGGTG -> AACTATGGTGG
AACTATGGTGG -> ACTATGGTGGG
ACTATGGTGGG -> CTATGGTGGGA
CTATGGTGGGA -> TATGGTGGGAC
TATGGTGGGAC -> ATGGTGGGACG
ATGGTGGGACG -> TGGTGGGACGT
TGGTGGGACGT -> GGTGGGACGTT
GGTGGGACGTT -> GTGGGACGTTT
GTGGGACGTTT -> TGGGACGTTTT
TGGGACGTTTT -> GGGACGTTTTG
GGGACGTTTTG -> GGACGTTTTGA
GGACGTTTTGA -> GACGTTTTGAG
GACGTTTTGAG -> ACGTTTTGAGA
ACGTTTTGAGA -> CGTTTTGAGAC
CGTTTTGAGAC -> GTTTTGAGACT
GTTTTGAGACT -> TTTTGAGACTG
TTTTGAGACTG -> TTTGAGACTGC
TTTGAGACTGC -> TTGAGACTGCC
TTGAGACTGCC -> TGAGACTGCCG
TGAGACTGCCG -> GAGACTGCCGG
GAGACTGCCGG -> AGACTGCCGGG
AGACTGCCGGG -> GACTGCCGGGG
GACTGCCGGGG -> ACTGCCGGGGC
ACTGCCGGGGC -> CTGCCGGGGCG
CTGCCGGGGCG -> TGCCGGGGCGC
TGCCGGGGCGC -> GCCGGGGCGCC
GCCGGGGCGCC -> CCGGGGCGCCG
CCGGGGCGCCG -> CGGGGCGCCGA
CGGGGCGCCGA -> GGGGCGCCGAC
GGGGCGCCGAC -> GGGCGCCGACC
GGGCGCCGACC -> GGCGCCGACCG
GGCGCCGACCG -> GCGCCGACCGC
GCGCCGACCGC -> CGCCGACCGCT
CGCCGACCGCT -> GCCGACCGCTG
GCCGACCGCTG -> CCGACCGCTGT
CCGACCGCTGT -> CGACCGCTGTT
CGACCGCTGTT -> GACCGCTGTTG
GACCGCTGTTG -> ACCGCTGTTGT
ACCGCTGTTGT -> CCGCTGTTGTC
CCGCTGTTGTC -> CGCTGTTGTCG
CGCTGTTGTCG -> GCTGTTGTCGT
GCTGTTGTCGT -> CTGTTGTCGTC
CTGTTGTCGTC -> TGTTGTCGTCT
TGTTGTCGTCT -> GTTGTCGTCTG
GTTGTCGTCTG -> TTGTCGTCTGA
TTGTCGTCTGA -> TGTCGTCTGAC
TGTCGTCTGAC -> GTCGTCTGACT
GTCGTCTGACT -> TCGTCTGACTG
TCGTCTGACTG -> CGTCTGACTGG
CGTCTGACTGG -> GTCTGACTGGC
GTCTGACTGGC -> TCTGACTGGCT
TCTGACTGGCT -> CTGACTGGCTT
CTGACTGGCTT -> TGACTGGCTTC
TGACTGGCTTC -> GACTGGCTTCA
GACTGGCTTCA -> ACTGGCTTCAG
ACTGGCTTCAG -> CTGGCTTCAGC
CTGGCTTCAGC -> TGGCTTCAGCC
TGGCTTCAGCC -> GGCTTCAGCCC
GGCTTCAGCCC -> GCTTCAGCCCG
GCTTCAGCCCG -> CTTCAGCCCGC
CTTCAGCCCGC -> TTCAGCCCGCG
TTCAGCCCGCG -> TCAGCCCGCGA
TCAGCCCGCGA -> CAGCCCGCGAT
CAGCCCGCGAT -> AGCCCGCGATA
AGCCCGCGATA -> GCCCGCGATAG
GCCCGCGATAG -> CCCGCGATAGG
CCCGCGATAGG -> CCGCGATAGGG
CCGCGATAGGG -> CGCGATAGGGG
CGCGATAGGGG -> GCGATAGGGGT
GCGATAGGGGT -> CGATAGGGGTC
CGATAGGGGTC -> GATAGGGGTCT
GATAGGGGTCT -> ATAGGGGTCTT
ATAGGGGTCTT -> TAGGGGTCTTA
TAGGGGTCTTA -> AGGGGTCTTAA
AGGGGTCTTAA -> GGGGTCTTAAT
GGGGTCTTAAT -> GGGTCTTAATC
GGGTCTTAATC -> GGTCTTAATCC
GGTCTTAATCC -> GTCTTAATCCT
GTCTTAATCCT -> TCTTAATCCTG
TCTTAATCCTG -> CTTAATCCTGT
CTTAATCCTGT -> TTAATCCTGTG
TTAATCCTGTG -> TAATCCTGTGT
TAATCCTGTGT -> AATCCTGTGTT
AATCCTGTGTT -> ATCCTGTGTTG
ATCCTGTGTTG -> TCCTGTGTTGG
TCCTGTGTTGG -> CCTGTGTTGGG
CCTGTGTTGGG -> CTGTGTTGGGC
CTGTGTTGGGC -> TGTGTTGGGCC
TGTGTTGGGCC -> GTGTTGGGCCT
GTGTTGGGCCT -> TGTTGGGCCTC
TGTTGGGCCTC -> GTTGGGCCTCC
GTTGGGCCTCC -> TTGGGCCTCCA
TTGGGCCTCCA -> TGGGCCTCCAA
TGGGCCTCCAA -> GGGCCTCCAAT
GGGCCTCCAAT -> GGCCTCCAATA
GGCCTCCAATA -> GCCTCCAATAG
GCCTCCAATAG -> CCTCCAATAGG
CCTCCAATAGG -> CTCCAATAGGC
CTCCAATAGGC -> TCCAATAGGCG
TCCAATAGGCG -> CCAATAGGCGA
CCAATAGGCGA -> CAATAGGCGAA
CAATAGGCGAA -> AATAGGCGAAG
AATAGGCGAAG -> ATAGGCGAAGG
ATAGGCGAAGG -> TAGGCGAAGGC
TAGGCGAAGGC -> AGGCGAAGGCT
AGGCGAAGGCT -> GGCGAAGGCTC
GGCGAAGGCTC -> GCGAAGGCTCC
GCGAAGGCTCC -> CGAAGGCTCCT
CGAAGGCTCCT -> GAAGGCTCCTA
GAAGGCTCCTA -> AAGGCTCCTAT
AAGGCTCCTAT -> AGGCTCCTATC
AGGCTCCTATC -> GGCTCCTATCG
GGCTCCTATCG -> GCTCCTATCGC
GCTCCTATCGC -> CTCCTATCGCT
CTCCTATCGCT -> TCCTATCGCTA
TCCTATCGCTA -> CCTATCGCTAC
CCTATCGCTAC -> CTATCGCTACA
CTATCGCTACA -> TATCGCTACAG
TATCGCTACAG -> ATCGCTACAGG
ATCGCTACAGG -> TCGCTACAGGA
TCGCTACAGGA -> CGCTACAGGAT
CGCTACAGGAT -> GCTACAGGATT
GCTACAGGATT -> CTACAGGATTC
CTACAGGATTC -> TACAGGATTCC
TACAGGATTCC -> ACAGGATTCCT
ACAGGATTCCT -> CAGGATTCCTG
CAGGATTCCTG -> AGGATTCCTGA
AGGATTCCTGA -> GGATTCCTGAC
GGATTCCTGAC -> GATTCCTGACT
GATTCCTGACT -> ATTCCTGACTT
ATTCCTGACTT -> TTCCTGACTTT
TTCCTGACTTT -> TCCTGACTTTA
TCCTGACTTTA -> CCTGACTTTAC
CCTGACTTTAC -> CTGACTTTACT
CTGACTTTACT -> TGACTTTACTC
TGACTTTACTC -> GACTTTACTCT
GACTTTACTCT -> ACTTTACTCTG
ACTTTACTCTG -> CTTTACTCTGA
CTTTACTCTGA -> TTTACTCTGAG
TTTACTCTGAG -> TTACTCTGAGT
TTACTCTGAGT -> TACTCTGAGTC
TACTCTGAGTC -> ACTCTGAGTCA
ACTCTGAGTCA -> CTCTGAGTCAA
CTCTGAGTCAA -> TCTGAGTCAAC
TCTGAGTCAAC -> CTGAGTCAACT
CTGAGTCAACT -> TGAGTCAACTT
TGAGTCAACTT -> GAGTCAACTTG
GAGTCAACTTG -> AGTCAACTTGC
AGTCAACTTGC -> GTCAACTTGCT
GTCAACTTGCT -> TCAACTTGCTC
TCAACTTGCTC -> CAACTTGCTCG
CAACTTGCTCG -> AACTTGCTCGT
AACTTGCTCGT -> ACTTGCTCGTG
ACTTGCTCGTG -> CTTGCTCGTGA
CTTGCTCGTGA -> TTGCTCGTGAC
TTGCTCGTGAC -> TGCTCGTGACG
TGCTCGTGACG -> GCTCGTGACGG
GCTCGTGACGG -> CTCGTGACGGT
CTCGTGACGGT -> TCGTGACGGTA
TCGTGACGGTA -> CGTGACGGTAT
CGTGACGGTAT -> GTGACGGTATT
GTGACGGTATT -> TGACGGTATTC
TGACGGTATTC -> GACGGTATTCT
GACGGTATTCT -> ACGGTATTCTC
ACGGTATTCTC -> CGGTATTCTCT
CGGTATTCTCT -> GGTATTCTCTG
GGTATTCTCTG -> GTATTCTCTGA
GTATTCTCTGA -> TATTCTCTGAA
TATTCTCTGAA -> ATTCTCTGAAC
ATTCTCTGAAC -> TTCTCTGAACC
TTCTCTGAACC -> TCTCTGAACCC
TCTCTGAACCC -> CTCTGAACCCC
CTCTGAACCCC -> TCTGAACCCCC
TCTGAACCCCC -> CTGAACCCCCA
CTGAACCCCCA -> TGAACCCCCAT
TGAACCCCCAT -> GAACCCCCATA
GAACCCCCATA -> AACCCCCATAC
AACCCCCATAC -> ACCCCCATACG
ACCCCCATACG -> CCCCCATACGT
CCCCCATACGT -> CCCCATACGTT
CCCCATACGTT -> CCCATACGTTA
CCCATACGTTA -> CCATACGTTAA
CCATACGTTAA -> CATACGTTAAG
CATACGTTAAG -> ATACGTTAAGG
ATACGTTAAGG -> TACGTTAAGGA
TACGTTAAGGA -> ACGTTAAGGAG
ACGTTAAGGAG -> CGTTAAGGAGC
CGTTAAGGAGC -> GTTAAGGAGCG
GTTAAGGAGCG -> TTAAGGAGCGC
TTAAGGAGCGC -> TAAGGAGCGCC
TAAGGAGCGCC -> AAGGAGCGCCT
AAGGAGCGCCT -> AGGAGCGCCTG
AGGAGCGCCTG -> GGAGCGCCTGT
GGAGCGCCTGT -> GAGCGCCTGTA
GAGCGCCTGTA -> AGCGCCTGTAA
AGCGCCTGTAA -> GCGCCTGTAAC
GCGCCTGTAAC -> CGCCTGTAACC
CGCCTGTAACC -> GCCTGTAACCA
GCCTGTAACCA -> CCTGTAACCAG
CCTGTAACCAG -> CTGTAACCAGC
CTGTAACCAGC -> TGTAACCAGCG
TGTAACCAGCG -> GTAACCAGCGC
GTAACCAGCGC -> TAACCAGCGCT
TAACCAGCGCT -> AACCAGCGCTA
AACCAGCGCTA -> ACCAGCGCTAA
ACCAGCGCTAA -> CCAGCGCTAAT
CCAGCGCTAAT -> CAGCGCTAATG
CAGCGCTAATG -> AGCGCTAATGG
AGCGCTAATGG -> GCGCTAATGGT
GCGCTAATGGT -> CGCTAATGGTC
CGCTAATGGTC -> GCTAATGGTCA
GCTAATGGTCA -> CTAATGGTCAG
CTAATGGTCAG -> TAATGGTCAGC
TAATGGTCAGC -> AATGGTCAGCA
AATGGTCAGCA -> ATGGTCAGCAT
ATGGTCAGCAT -> TGGTCAGCATG
TGGTCAGCATG -> GGTCAGCATGG
GGTCAGCATGG -> GTCAGCATGGC
GTCAGCATGGC -> TCAGCATGGCT
TCAGCATGGCT -> CAGCATGGCTA
CAGCATGGCTA -> AGCATGGCTAA
AGCATGGCTAA -> GCATGGCTAAC
GCATGGCTAAC -> CATGGCTAACA
CATGGCTAACA -> ATGGCTAACAG
ATGGCTAACAG -> TGGCTAACAGC
TGGCTAACAGC -> GGCTAACAGCT
GGCTAACAGCT -> GCTAACAGCTC
GCTAACAGCTC -> CTAACAGCTCG
CTAACAGCTCG -> TAACAGCTCGC
TAACAGCTCGC -> AACAGCTCGCA
AACAGCTCGCA -> ACAGCTCGCAG
ACAGCTCGCAG -> CAGCTCGCAGG
AGCTCGCAGGC -> GCTCGCAGGCA
GCTCGCAGGCA -> CTCGCAGGCAC
CTCGCAGGCAC -> TCGCAGGCACT
TCGCAGGCACT -> CGCAGGCACTG
CGCAGGCACTG -> GCAGGCACTGC
GCAGGCACTGC -> CAGGCACTGCT
CAGGCACTGCT -> AGGCACTGCTC
AGGCACTGCTC -> GGCACTGCTCT
GGCACTGCTCT -> GCACTGCTCTT
GCACTGCTCTT -> CACTGCTCTTC
CACTGCTCTTC -> ACTGCTCTTCG
ACTGCTCTTCG -> CTGCTCTTCGT
CTGCTCTTCGT -> TGCTCTTCGTG
TGCTCTTCGTG -> GCTCTTCGTGA
GCTCTTCGTGA -> CTCTTCGTGAG
CTCTTCGTGAG -> TCTTCGTGAGC
TCTTCGTGAGC -> CTTCGTGAGCA
CTTCGTGAGCA -> TTCGTGAGCAC
TTCGTGAGCAC -> TCGTGAGCACA
TCGTGAGCACA -> CGTGAGCACAA
CGTGAGCACAA -> GTGAGCACAAC
GTGAGCACAAC -> TGAGCACAACA
TGAGCACAACA -> GAGCACAACAA
GAGCACAACAA -> AGCACAACAAC
AGCACAACAAC -> GCACAACAACA
GCACAACAACA -> CACAACAACAG
CACAACAACAG -> ACAACAACAGC
ACAACAACAGC -> CAACAACAGCT
CAACAACAGCT -> AACAACAGCTG
AACAACAGCTG -> ACAACAGCTGG
ACAACAGCTGG -> CAACAGCTGGC
CAACAGCTGGC -> AACAGCTGGCA
AACAGCTGGCA -> ACAGCTGGCAA
ACAGCTGGCAA -> CAGCTGGCAAA
CAGCTGGCAAA -> AGCTGGCAAAA
AGCTGGCAAAA -> GCTGGCAAAAG
GCTGGCAAAAG -> CTGGCAAAAGG
CTGGCAAAAGG -> TGGCAAAAGGA
TGGCAAAAGGA -> GGCAAAAGGAG
GGCAAAAGGAG -> GCAAAAGGAGA
GCAAAAGGAGA -> CAAAAGGAGAC
CAAAAGGAGAC -> AAAAGGAGACA
AAAAGGAGACA -> AAAGGAGACAT
AAAGGAGACAT -> AAGGAGACATC
AAGGAGACATC -> AGGAGACATCA
AGGAGACATCA -> GGAGACATCAA
GGAGACATCAA -> GAGACATCAAA
GAGACATCAAA -> AGACATCAAAC
AGACATCAAAC -> GACATCAAACT
GACATCAAACT -> ACATCAAACTA
ACATCAAACTA -> CATCAAACTAC
CATCAAACTAC -> ATCAAACTACG
ATCAAACTACG -> TCAAACTACGC
TCAAACTACGC -> CAAACTACGCG
CAAACTACGCG -> AAACTACGCGC
AAACTACGCGC -> AACTACGCGCA
AACTACGCGCA -> ACTACGCGCAA
ACTACGCGCAA -> CTACGCGCAAC
CTACGCGCAAC -> TACGCGCAACG
TACGCGCAACG -> ACGCGCAACGC