ACGTTACTCCCGCAAGCAT -> CGTTACTCCCGCAAGCATC
ACTAATACGCTAGAAGAGG -> CTAATACGCTAGAAGAGGC
TATGCGTTTATTTAGTGGC -> ATGCGTTTATTTAGTGGCA
CCCTAATAATAAATCTTAT -> CCTAATAATAAATCTTATA
TATTTCGTGTAGAGCAATT -> ATTTCGTGTAGAGCAATTG
CAAGGAGCCGGCTTGCGAA -> AAGGAGCCGGCTTGCGAAT
CCAAGAGAGGGACTCAAAT -> CAAGAGAGGGACTCAAATG
TAGCAATGATTGGGTAACT -> AGCAATGATTGGGTAACTT
GCCCACAGTGGAATGTTCA -> CCCACAGTGGAATGTTCAA
CGGTTTATGGAGATGGAGC -> GGTTTATGGAGATGGAGCG
AGTATGCGGCGGCGAATCG -> GTATGCGGCGGCGAATCGT
TGTTTGCCGTTAAGCTCGA -> GTTTGCCGTTAAGCTCGAG
GACCTACCTGGGCCACTCA -> ACCTACCTGGGCCACTCAG
ATGCGAAAGCAGTACTAGC -> TGCGAAAGCAGTACTAGCC
ATCCTGAAATTAAGAAATC -> TCCTGAAATTAAGAAATCC
TTTCGTAGACTAAATTCGA -> TTCGTAGACTAAATTCGAC
GACTCAGGACGGCATGGTA -> ACTCAGGACGGCATGGTAT
CTGATGTGTAAATCCCAAC -> TGATGTGTAAATCCCAACC
CGGCTTTAGCCGTCAGGGT -> GGCTTTAGCCGTCAGGGTC
CCAGTTCGGAGCCGGTTTA -> CAGTTCGGAGCCGGTTTAT
ACTTCCAATCCCTGTAGCA -> CTTCCAATCCCTGTAGCAA
GCAAACGGCTGCGGGACGA -> CAAACGGCTGCGGGACGAT
TCGAAGCCTTGGATGTTTG -> CGAAGCCTTGGATGTTTGC
TGGCGCTATTAACATAGAC -> GGCGCTATTAACATAGACA
CCTCCGGCGGAGGGGCAGG -> CTCCGGCGGAGGGGCAGGG
TGAGTAGTTGACCCTTTTC -> GAGTAGTTGACCCTTTTCC
CCGCACTACCATTGCTTAA -> CGCACTACCATTGCTTAAG
CATTGATCCCGGTCGTGTC -> ATTGATCCCGGTCGTGTCT
AGTATTTTATGCGTTTATT -> GTATTTTATGCGTTTATTT
GAGGCACTTCCAATCCCTG -> AGGCACTTCCAATCCCTGT
AGCGTACCTGGTGAGGTCT -> GCGTACCTGGTGAGGTCTT
CGTAGCGACGGGTGATATA -> GTAGCGACGGGTGATATAA
TTGCCACTCGATATGTCAT -> TGCCACTCGATATGTCATA
ACGCTCAGCTCGACACGGC -> CGCTCAGCTCGACACGGCC
TTCGGCACCAACTAGAAGA -> TCGGCACCAACTAGAAGAG
TGATGTGTAAATCCCAACC -> GATGTGTAAATCCCAACCC
CCCTGAAATAAATCGCGAA -> CCTGAAATAAATCGCGAAG
CATTTCTGAGTAGTTGACC -> ATTTCTGAGTAGTTGACCC
GAAGAGGCCCTCCGGCCCA -> AAGAGGCCCTCCGGCCCAC
TTTAATATTGGGGAGACTC -> TTAATATTGGGGAGACTCC
GTACCATAGTACAGAACTG -> TACCATAGTACAGAACTGC
GCTGTTATACGCTGCACGT -> CTGTTATACGCTGCACGTT
ACTGCGCCGATATCCCGGT -> CTGCGCCGATATCCCGGTC
TTCCTAAAAGAGTACGCAA -> TCCTAAAAGAGTACGCAAT
GCGTTTATTTAGTGGCACA -> CGTTTATTTAGTGGCACAA
GTTGACCCTTTTCCGGCTT -> TTGACCCTTTTCCGGCTTG
CTCGGGGAGTATGCGGCGG -> TCGGGGAGTATGCGGCGGC
ACGAACTGTGAGGATAAAG -> CGAACTGTGAGGATAAAGC
TGTAGAGCAATTGCCACTC -> GTAGAGCAATTGCCACTCG
ACACTGGATTCTCGGGTTT -> CACTGGATTCTCGGGTTTT
CATGGGCAGGCGTCTTATT -> ATGGGCAGGCGTCTTATTT
GACACGGCCCTGAACTCTA -> ACACGGCCCTGAACTCTAA
CAGGATGCAGTCGCAAATC -> AGGATGCAGTCGCAAATCC
CCGGCAAGTGGACTTTGTT -> CGGCAAGTGGACTTTGTTG
GTCCACAAGGAGCCGGCTT -> TCCACAAGGAGCCGGCTTG
ATCCGAGTTTACATAGGCT -> TCCGAGTTTACATAGGCTC
CATCAGCAATGAGGTAGTG -> ATCAGCAATGAGGTAGTGT
AGCAAACAACTGAACAGTA -> GCAAACAACTGAACAGTAA
TGCGCCTCACAGAATTATG -> GCGCCTCACAGAATTATGT
CCATTGCTTAAGTTATTCG -> CATTGCTTAAGTTATTCGG
GTGCGTTACGTGATTTAAT -> TGCGTTACGTGATTTAATA
CTCGTGCCGTCGGTCCAGG -> TCGTGCCGTCGGTCCAGGC
AGCGACTAGTTTCAGATAG -> GCGACTAGTTTCAGATAGC
GCAGACGCGTCTGCAACCG -> CAGACGCGTCTGCAACCGC
GCCTCACAGAATTATGTGG -> CCTCACAGAATTATGTGGC
TTATGTGGCGAATGTTAGC -> TATGTGGCGAATGTTAGCA
TCACGTGGGATTCCTCATC -> CACGTGGGATTCCTCATCA
CTTATCTTGCACGATCCGC -> TTATCTTGCACGATCCGCC
AGACGCGTCTGCAACCGCG -> GACGCGTCTGCAACCGCGC
CTCCGGCGCAAAATGCTCG -> TCCGGCGCAAAATGCTCGC
CAAGTCACGTGGGATTCCT -> AAGTCACGTGGGATTCCTC
ACTGTCCAAGCATACGGAC -> CTGTCCAAGCATACGGACA
CAGAACTGCAGGGGCACGT -> AGAACTGCAGGGGCACGTG
TCTTCACGCATTAGTGGCG -> CTTCACGCATTAGTGGCGC
CACCAACTAGAAGAGGCCC -> ACCAACTAGAAGAGGCCCT
ATGTCATACTTGGGTGTGC -> TGTCATACTTGGGTGTGCC
CAGGACATGGGCAGGCGTC -> AGGACATGGGCAGGCGTCT
CTTAGCTGTTATACGCTGC -> TTAGCTGTTATACGCTGCA
TGCAGTCGCAAATCCTTTC -> GCAGTCGCAAATCCTTTCG
ACGCTGCACGTTTACATGT -> CGCTGCACGTTTACATGTT
CTCCTGATGTGTAAATCCC -> TCCTGATGTGTAAATCCCA
GTAAGGACGCTCAGCTCGA -> TAAGGACGCTCAGCTCGAC
CGTGATGAGAAGGCCAGAT -> GTGATGAGAAGGCCAGATC
GCCAACGGAATCGCGGAAT -> CCAACGGAATCGCGGAATT
CGGTCCAGGCTTCTCATCT -> GGTCCAGGCTTCTCATCTT
ATTCCCGACATTTCGTAGA -> TTCCCGACATTTCGTAGAC
GTATGCGGCGGCGAATCGT -> TATGCGGCGGCGAATCGTA
TGCCGTTAAGCTCGAGAGC -> GCCGTTAAGCTCGAGAGCT
AGTTGACCCTTTTCCGGCT -> GTTGACCCTTTTCCGGCTT
GCTCATCATGCTATGGAGG -> CTCATCATGCTATGGAGGA
CCAATCCCTGTAGCAATGA -> CAATCCCTGTAGCAATGAT
CGATATGTCATACTTGGGT -> GATATGTCATACTTGGGTG
AAAAGAGTACGCAATTGTT -> AAAGAGTACGCAATTGTTG
TTCGTAGACTAAATTCGAC -> TCGTAGACTAAATTCGACT
CGAGCCTCCGCTTATGCGA -> GAGCCTCCGCTTATGCGAA
GCTAGAAGAGGCCCTCCGG -> CTAGAAGAGGCCCTCCGGC,CTAGAAGAGGCCCTCCGGC,CTAGAAGAGGCCCTCCGGC
CGCGTGTGGGGCCAGGACA -> GCGTGTGGGGCCAGGACAT
CAGGACGGCATGGTATTAC -> AGGACGGCATGGTATTACT
CGGGATCAAGCCTATAAAC -> GGGATCAAGCCTATAAACG
TTTCGGCACCAACTAGAAG -> TTCGGCACCAACTAGAAGA
CGTAGCTCTCGTGCCGTCG -> GTAGCTCTCGTGCCGTCGG
TAATCCAGTTATTGCCGTG -> AATCCAGTTATTGCCGTGG
TGATTGGGTAACTTGAGAT -> GATTGGGTAACTTGAGATA
CGCGGAATTCTCCTGATGT -> GCGGAATTCTCCTGATGTG
CAATCCCTGTAGCAATGAT -> AATCCCTGTAGCAATGATT
AACGGCTGTGATCCAAAAC -> ACGGCTGTGATCCAAAACT
CAAGTGGCTTGCTCATCAT -> AAGTGGCTTGCTCATCATG
CTCAGCTCGACACGGCCCT -> TCAGCTCGACACGGCCCTG
ATGCCGGTTGTAGAATTCA -> TGCCGGTTGTAGAATTCAA
GGGTCTGTGAAACTATACA -> GGTCTGTGAAACTATACAA
GAAGAGGCCCTCCGGCTTT -> AAGAGGCCCTCCGGCTTTA
TAATAATAAATCTTATACC -> AATAATAAATCTTATACCA
GCCGTTAAGCTCGAGAGCT -> CCGTTAAGCTCGAGAGCTG
CGCTTATGCGAAAGCAGTA -> GCTTATGCGAAAGCAGTAC
TCATTGATCCCGGTCGTGT -> CATTGATCCCGGTCGTGTC
ATACTGCTTATCTTGCACG -> TACTGCTTATCTTGCACGA
ATATCCCGGTCGTGTCTAG -> TATCCCGGTCGTGTCTAGT
TTGTACAGCAAACAACTGA -> TGTACAGCAAACAACTGAA
CGTGTCTAGTCCTATTGTA -> GTGTCTAGTCCTATTGTAT
GTGGCACAATTGTCTATTT -> TGGCACAATTGTCTATTTC
ATGTCCTGCCAACGGAATC -> TGTCCTGCCAACGGAATCG
TTCACGCATTAGTGGCGCT -> TCACGCATTAGTGGCGCTA
GGGCACTCGTTGACCTACC -> GGCACTCGTTGACCTACCT
GCGCCTCACAGAATTATGT -> CGCCTCACAGAATTATGTG
AACTGTGAGGATAAAGCGT -> ACTGTGAGGATAAAGCGTA
GCGTTACGTGATTTAATAT -> CGTTACGTGATTTAATATT
GCTCAGCTCGACACGGCCC -> CTCAGCTCGACACGGCCCT
CATTGAATACTGCTTATCT -> ATTGAATACTGCTTATCTT
TTATTTAGTGGCACAATTG -> TATTTAGTGGCACAATTGT
ACCCTTTTCCGGCTTGTCG -> CCCTTTTCCGGCTTGTCGG
GGATGCAGTCGCAAATCCT -> GATGCAGTCGCAAATCCTT
AGTAGTTGACCCTTTTCCG -> GTAGTTGACCCTTTTCCGG
TACGTGATTTAATATTGGG -> ACGTGATTTAATATTGGGG
TGAGGTAGTGTCGACCAAA -> GAGGTAGTGTCGACCAAAT
CAGATAGCACCCGCACTAC -> AGATAGCACCCGCACTACC
TGGGAACCCAATGTTAACC -> GGGAACCCAATGTTAACCA
TGCCGTGGGCATCGATTTC -> GCCGTGGGCATCGATTTCT
ATCCCGGTCGTGTCTAGTT -> TCCCGGTCGTGTCTAGTTT
TACCTTTAGTCAGTTAGTA -> ACCTTTAGTCAGTTAGTAG
GGCTTGTCGGGATCAAGCC -> GCTTGTCGGGATCAAGCCT
CACAGAGCATTGAATACTG -> ACAGAGCATTGAATACTGC
ACTTCCTAAAAGAGTACGC -> CTTCCTAAAAGAGTACGCA
ATGGTCCAGGCCATTTCTT -> TGGTCCAGGCCATTTCTTT
ATCCTAACTATCCTATACG -> TCCTAACTATCCTATACGC
CAGTACTAGCCCACAGTGG -> AGTACTAGCCCACAGTGGA
AAATCGCACATATGTTTCG -> AATCGCACATATGTTTCGT
AGAATTATGTGGCGAATGT -> GAATTATGTGGCGAATGTT
GGTGTGCGCCTCACAGAAT -> GTGTGCGCCTCACAGAATT
GAAGAGGCCCTCCGGCAAG -> AAGAGGCCCTCCGGCAAGT
GTTTCGTCGAAGAGCGTGA -> TTTCGTCGAAGAGCGTGAG
CCTAATAATAAATCTTATA -> CTAATAATAAATCTTATAC
ATCGTAGCGACGGGTGATA -> TCGTAGCGACGGGTGATAT
GGACTTCCTAAAAGAGTAC -> GACTTCCTAAAAGAGTACG
GCAAGCATCAGGATGCAGT -> CAAGCATCAGGATGCAGTC
TAATACGCTAGAAGAGGCC -> AATACGCTAGAAGAGGCCC
AAAGCGTACCTGGTGAGGT -> AAGCGTACCTGGTGAGGTC
GGCGATTGGCATTACATAT -> GCGATTGGCATTACATATT
CTTGCGATTGGTTGCTGGT -> TTGCGATTGGTTGCTGGTT
AAAATTTATTCCCGACATT -> AAATTTATTCCCGACATTT
ATTAGTTTGTAGAGGTGTG -> TTAGTTTGTAGAGGTGTGC
GGGAGACTCCCTGCATGAA -> GGAGACTCCCTGCATGAAG
GGCACTTCCAATCCCTGTA -> GCACTTCCAATCCCTGTAG
ACCATTGCTTAAGTTATTC -> CCATTGCTTAAGTTATTCG
TGCTAGAAGAGGCCCTCCG -> GCTAGAAGAGGCCCTCCGG
ACAGAACTGCAGGGGCACG -> CAGAACTGCAGGGGCACGT
CAAAAGGACTCAGGACGGC -> AAAAGGACTCAGGACGGCA
AAATAAATCGCGAAGAGCC -> AATAAATCGCGAAGAGCCT
TGGTGTCTTGTAGGGCATG -> GGTGTCTTGTAGGGCATGG
GTTTACATGTTTGACCATC -> TTTACATGTTTGACCATCT
TATTTTATGCGTTTATTTA -> ATTTTATGCGTTTATTTAG
TGCTTAAGTTATTCGGCGA -> GCTTAAGTTATTCGGCGAT
TGTCTAGTGCACTAATACG -> GTCTAGTGCACTAATACGC
GATTTCTGCGATGCCGGTT -> ATTTCTGCGATGCCGGTTG
GTCCTGCCAACGGAATCGC -> TCCTGCCAACGGAATCGCG
CCTGTAGCAATGATTGGGT -> CTGTAGCAATGATTGGGTA
GGTTTTCCACACAAAAGCG -> GTTTTCCACACAAAAGCGA
ACGGCCCTGAACTCTAAAA -> CGGCCCTGAACTCTAAAAA
AATGTTCAAGGTTTGTTGA -> ATGTTCAAGGTTTGTTGAA
GGCAGGCGTCTTATTTTCA -> GCAGGCGTCTTATTTTCAT
AAACGAACTGTGAGGATAA -> AACGAACTGTGAGGATAAA
ATTGTATGCTAGAAGAGGC -> TTGTATGCTAGAAGAGGCC
TGTCTAGTTTCGGCACCAA -> GTCTAGTTTCGGCACCAAC
ACGGCTGTGATCCAAAACT -> CGGCTGTGATCCAAAACTA
GAATGTTAGCACATTCCGT -> AATGTTAGCACATTCCGTC
TGTTCAAGGTTTGTTGAAG -> GTTCAAGGTTTGTTGAAGT
GTCGGTCCAGGCTTCTCAT -> TCGGTCCAGGCTTCTCATC
AACGTCCCGTCGGTCACTC -> ACGTCCCGTCGGTCACTCG
TCGTGTCTAGTCCTATTGT -> CGTGTCTAGTCCTATTGTA
AAATCGCGAAGAGCCTGCC -> AATCGCGAAGAGCCTGCCC
AAAATTAGCGATGGTACCT -> AAATTAGCGATGGTACCTT
CGATGGTACCTTTAGTCAG -> GATGGTACCTTTAGTCAGT
ACCTTCATTTCTGAGTAGT -> CCTTCATTTCTGAGTAGTT
GCCGGCTTGCGAATACCTT -> CCGGCTTGCGAATACCTTC
ACTCTAAAAAACTACCCTA -> CTCTAAAAAACTACCCTAT
GAACTGCAGGGGCACGTGT -> AACTGCAGGGGCACGTGTC
AATGGGAACCCAATGTTAA -> ATGGGAACCCAATGTTAAC
TCATACTTGGGTGTGCCTC -> CATACTTGGGTGTGCCTCT
ATCGCTGCATCGAAGCCTT -> TCGCTGCATCGAAGCCTTG
TTATTCGGCGATTGGCATT -> TATTCGGCGATTGGCATTA
AGCTGCAAGTCACGTGGGA -> GCTGCAAGTCACGTGGGAT
GCTCTCGTGCCGTCGGTCC -> CTCTCGTGCCGTCGGTCCA
CAACCCTGAAATAAATCGC -> AACCCTGAAATAAATCGCG
CCAATGTTAACCAACGGCT -> CAATGTTAACCAACGGCTG
TTTCCACACAAAAGCGACT -> TTCCACACAAAAGCGACTA
CCAGGCAATGGGAACCCAA -> CAGGCAATGGGAACCCAAT
GTTTTCCACACAAAAGCGA -> TTTTCCACACAAAAGCGAC
AGTACCATAGTACAGAACT -> GTACCATAGTACAGAACTG
GTGATCCAAAACTAATCCA -> TGATCCAAAACTAATCCAG
CTGCGATGCCGGTTGTAGA -> TGCGATGCCGGTTGTAGAA
CAGTTAGTAGTATTTTATG -> AGTTAGTAGTATTTTATGC
CCAACTAGAAGAGGCCCTC -> CAACTAGAAGAGGCCCTCC
ACTATACAAAGACGCACTT -> CTATACAAAGACGCACTTA
CGTGATTTAATATTGGGGA -> GTGATTTAATATTGGGGAG
CGATGCCGGTTGTAGAATT -> GATGCCGGTTGTAGAATTC
CTTGATCGCGTGATGAGAA -> TTGATCGCGTGATGAGAAG
CGTACCTGGTGAGGTCTTA -> GTACCTGGTGAGGTCTTAC
CAAATCGCACATATGTTTC -> AAATCGCACATATGTTTCG
TCTCGGGTTTTCCACACAA -> CTCGGGTTTTCCACACAAA
TCCGTAGGAGCTACCCGGA -> CCGTAGGAGCTACCCGGAT
CCCGGTCGTGTCTAGTGCA -> CCGGTCGTGTCTAGTGCAC
ATTTAATATTGGGGAGACT -> TTTAATATTGGGGAGACTC
GTAGCTCTCGTGCCGTCGG -> TAGCTCTCGTGCCGTCGGT
GATATAACGTTACTCCCGC -> ATATAACGTTACTCCCGCA
CGGCGGAGGGGCAGGGTGC -> GGCGGAGGGGCAGGGTGCG
ATAAATCTTATACCACGTC -> TAAATCTTATACCACGTCG
CGTGGGCATCGATTTCTGC -> GTGGGCATCGATTTCTGCG
GCGCCGATATCCCGGTCGT -> CGCCGATATCCCGGTCGTG
GGACATTGGTGTCTTGTAG -> GACATTGGTGTCTTGTAGG
AATCGCTGCATCGAAGCCT -> ATCGCTGCATCGAAGCCTT
GTCTTACTATTAAAATTTA -> TCTTACTATTAAAATTTAT
GCGGCGGCGAATCGTAGCG -> CGGCGGCGAATCGTAGCGA
GTCGGTCACTCGGGGAGTA -> TCGGTCACTCGGGGAGTAT
AGGGTGCGTTACGTGATTT -> GGGTGCGTTACGTGATTTA
TTACTATTAAAATTTATTC -> TACTATTAAAATTTATTCC
ACTTGGGTGTGCCTCTTCA -> CTTGGGTGTGCCTCTTCAC
TACTGCTTATCTTGCACGA -> ACTGCTTATCTTGCACGAT
TAAGGACGCTCAGCTCGAC -> AAGGACGCTCAGCTCGACA
AACTTGAGATATCTAATCG -> ACTTGAGATATCTAATCGC
GGACGCTCAGCTCGACACG -> GACGCTCAGCTCGACACGG
CATAGGCTCTCCCTTGCGA -> ATAGGCTCTCCCTTGCGAT
TCAAGCCTATAAACGTCCC -> CAAGCCTATAAACGTCCCG
AACTACCCTATTGGGGACT -> ACTACCCTATTGGGGACTT
GGGGCATCGGGGCACTCGT -> GGGCATCGGGGCACTCGTT
TCGCGGAATTCTCCTGATG -> CGCGGAATTCTCCTGATGT
GCGGAGGGGCAGGGTGCGT -> CGGAGGGGCAGGGTGCGTT
GGAGCCGGTTTATGGAGAT -> GAGCCGGTTTATGGAGATG
AGGCCCTCCGGCCCACCCA -> GGCCCTCCGGCCCACCCAG
CTTACTGAAATTAGTTTGT -> TTACTGAAATTAGTTTGTA
GCTCGCTAATGCAGACGCG -> CTCGCTAATGCAGACGCGT
CTACCATTGCTTAAGTTAT -> TACCATTGCTTAAGTTATT
GACCATCTAAGCTGCAAGT -> ACCATCTAAGCTGCAAGTC
AAATCCCAACCCTGAAATA -> AATCCCAACCCTGAAATAA
TCGGTCCAGGCTTCTCATC -> CGGTCCAGGCTTCTCATCT
GAGATATCTAATCGCTGCA -> AGATATCTAATCGCTGCAT
GCCGATATCCCGGTCGTGT -> CCGATATCCCGGTCGTGTC
TCTAAGCTGCAAGTCACGT -> CTAAGCTGCAAGTCACGTG
CACTCGGGGAGTATGCGGC -> ACTCGGGGAGTATGCGGCG
AATCCGTAGGAGCTACCCG -> ATCCGTAGGAGCTACCCGG
CGCTATTAACATAGACACA -> GCTATTAACATAGACACAA
ACATTCCGTCCAAGAGAGG -> CATTCCGTCCAAGAGAGGG
TGGTCCAGGCCATTTCTTT -> GGTCCAGGCCATTTCTTTA
GGACATGGGCAGGCGTCTT -> GACATGGGCAGGCGTCTTA
TGTGTAAATCCCAACCCTG -> GTGTAAATCCCAACCCTGA
CACTTCCAATCCCTGTAGC -> ACTTCCAATCCCTGTAGCA
TGCTCATCATGCTATGGAG -> GCTCATCATGCTATGGAGG
AGGCCATTTCTTTAGTTCC -> GGCCATTTCTTTAGTTCCC
CCCAGTTCGGAGCCGGTTT -> CCAGTTCGGAGCCGGTTTA
CTCACAGAATTATGTGGCG -> TCACAGAATTATGTGGCGA
CAAAATTAGCGATGGTACC -> AAAATTAGCGATGGTACCT
TCCCGATGAAGCAAGTACC -> CCCGATGAAGCAAGTACCA
CTAGAAGAGGCCCTCCGGC -> TAGAAGAGGCCCTCCGGCA,TAGAAGAGGCCCTCCGGCC,TAGAAGAGGCCCTCCGGCG,TAGAAGAGGCCCTCCGGCT
GCCCACTGCGCCGATATCC -> CCCACTGCGCCGATATCCC
CCTGCATGAAGGTCTTGAT -> CTGCATGAAGGTCTTGATC
TTAATATTGGGGAGACTCC -> TAATATTGGGGAGACTCCC
CTAGTCCTATTGTATGCTA -> TAGTCCTATTGTATGCTAG
AGCGTGAGGCACTTCCAAT -> GCGTGAGGCACTTCCAATC
CCTGCCCACTGCGCCGATA -> CTGCCCACTGCGCCGATAT
GCCCACCCAGTTCGGAGCC -> CCCACCCAGTTCGGAGCCG
TGTCTAGTAAGCTTTTTAG -> GTCTAGTAAGCTTTTTAGC
GTGGGCATCGATTTCTGCG -> TGGGCATCGATTTCTGCGA
AAGAGCCTGCCCACTGCGC -> AGAGCCTGCCCACTGCGCC
GTACCTTTAGTCAGTTAGT -> TACCTTTAGTCAGTTAGTA
AGGTCTTACTATTAAAATT -> GGTCTTACTATTAAAATTT
GTGAGGTCTTACTATTAAA -> TGAGGTCTTACTATTAAAA
ATGTTTGACCATCTAAGCT -> TGTTTGACCATCTAAGCTG
TACCTCTACGGTTCGTCCA -> ACCTCTACGGTTCGTCCAC
GGGCATGGGCGGAAAGCTT -> GGCATGGGCGGAAAGCTTA
CCCAACCCTGAAATAAATC -> CCAACCCTGAAATAAATCG
TTTTATGCGTTTATTTAGT -> TTTATGCGTTTATTTAGTG
GAGTAGTTGACCCTTTTCC -> AGTAGTTGACCCTTTTCCG
CTGCATCGAAGCCTTGGAT -> TGCATCGAAGCCTTGGATG
TGTAAATCCCAACCCTGAA -> GTAAATCCCAACCCTGAAA
CCGTAGGAGCTACCCGGAT -> CGTAGGAGCTACCCGGATA
GCTGCATCGAAGCCTTGGA -> CTGCATCGAAGCCTTGGAT
ACAGAGCATTGAATACTGC -> CAGAGCATTGAATACTGCT
GAGGATAAAGCGTACCTGG -> AGGATAAAGCGTACCTGGT
AGGACGGAGACGAACTGTC -> GGACGGAGACGAACTGTCC
CAAGGTTTGTTGAAGTCGC -> AAGGTTTGTTGAAGTCGCA
GCATCGAAGCCTTGGATGT -> CATCGAAGCCTTGGATGTT
ACGCAATTGTTGTTTCCGC -> CGCAATTGTTGTTTCCGCC
TCAAATGGTCCAGGCCATT -> CAAATGGTCCAGGCCATTT
GGCCCACCCAGTTCGGAGC -> GCCCACCCAGTTCGGAGCC
GGGCATCGGGGCACTCGTT -> GGCATCGGGGCACTCGTTG
TGGACTTTGTTGTTGTATA -> GGACTTTGTTGTTGTATAC
AAGGTTTGTTGAAGTCGCA -> AGGTTTGTTGAAGTCGCAA
CCGGCGGAGGGGCAGGGTG -> CGGCGGAGGGGCAGGGTGC
GTGTGCGCCTCACAGAATT -> TGTGCGCCTCACAGAATTA
ATTGGGGACTTCCTAAAAG -> TTGGGGACTTCCTAAAAGA
ACAAAGACGCACTTAGACC -> CAAAGACGCACTTAGACCA
TGCTACCCAAGTGGCTTGC -> GCTACCCAAGTGGCTTGCT
TCTGTGAAACTATACAAAG -> CTGTGAAACTATACAAAGA
GGCCAGGACATGGGCAGGC -> GCCAGGACATGGGCAGGCG
CGGTCGTGTCTAGTTTCGG -> GGTCGTGTCTAGTTTCGGC
ACCTGGTGAGGTCTTACTA -> CCTGGTGAGGTCTTACTAT
TTTATTTAGTGGCACAATT -> TTATTTAGTGGCACAATTG
TGGGCGGAAAGCTTACTGA -> GGGCGGAAAGCTTACTGAA
TGAGGTCTTACTATTAAAA -> GAGGTCTTACTATTAAAAT
TGGCTTGCTCATCATGCTA -> GGCTTGCTCATCATGCTAT
TGCAGACGCGTCTGCAACC -> GCAGACGCGTCTGCAACCG
ATGGTACCTTTAGTCAGTT -> TGGTACCTTTAGTCAGTTA
TTCCAATCCCTGTAGCAAT -> TCCAATCCCTGTAGCAATG
AGGTTTGTTGAAGTCGCAA -> GGTTTGTTGAAGTCGCAAA
GAGGGGCAGGGTGCGTTAC -> AGGGGCAGGGTGCGTTACG
AGGATAAAGCGTACCTGGT -> GGATAAAGCGTACCTGGTG
CCCACCGCATCCCGGTCGT -> CCACCGCATCCCGGTCGTG
AATACTGCTTATCTTGCAC -> ATACTGCTTATCTTGCACG
TGTTATACGCTGCACGTTT -> GTTATACGCTGCACGTTTA
TATTAAAATTTATTCCCGA -> ATTAAAATTTATTCCCGAC
ATTGCCACTCGATATGTCA -> TTGCCACTCGATATGTCAT
AATTGCAAGACACACTTAC -> ATTGCAAGACACACTTACT
CCTTAGCTGTTATACGCTG -> CTTAGCTGTTATACGCTGC
GCTTATGCGAAAGCAGTAC -> CTTATGCGAAAGCAGTACT
AGTTTCGGCACCAACTAGA -> GTTTCGGCACCAACTAGAA
GAATGTTCAAGGTTTGTTG -> AATGTTCAAGGTTTGTTGA
ATGGGCGGAAAGCTTACTG -> TGGGCGGAAAGCTTACTGA
TGTATGCTAGAAGAGGCCC -> GTATGCTAGAAGAGGCCCT
ACTCAGGACGGCATGGTAT -> CTCAGGACGGCATGGTATT
GGACGGCATGGTATTACTC -> GACGGCATGGTATTACTCC
AAGAGGCCCTCCGGCTTTA -> AGAGGCCCTCCGGCTTTAG
CCTGATGTGTAAATCCCAA -> CTGATGTGTAAATCCCAAC
ACATGGGCAGGCGTCTTAT -> CATGGGCAGGCGTCTTATT
AATCCCTGTAGCAATGATT -> ATCCCTGTAGCAATGATTG
CCTTTAGTCAGTTAGTAGT -> CTTTAGTCAGTTAGTAGTA
GTTTATTTAGTGGCACAAT -> TTTATTTAGTGGCACAATT
AGTCCTATTGTATGCTAGA -> GTCCTATTGTATGCTAGAA
ATATCTAATCGCTGCATCG -> TATCTAATCGCTGCATCGA
GATATGTCATACTTGGGTG -> ATATGTCATACTTGGGTGT
TCGCGAAGAGCCTGCCCAC -> CGCGAAGAGCCTGCCCACT
ATACTTGGGTGTGCCTCTT -> TACTTGGGTGTGCCTCTTC
AACGTTACTCCCGCAAGCA -> ACGTTACTCCCGCAAGCAT
AGGACGCTCAGCTCGACAC -> GGACGCTCAGCTCGACACG
GTTTATGGAGATGGAGCGT -> TTTATGGAGATGGAGCGTA
GGTCATCCTAACTATCCTA -> GTCATCCTAACTATCCTAT
TAGTAGTATTTTATGCGTT -> AGTAGTATTTTATGCGTTT
TTTAGTCAGTTAGTAGTAT -> TTAGTCAGTTAGTAGTATT
AAAAGGACTCAGGACGGCA -> AAAGGACTCAGGACGGCAT
TAACATAGACACAATTACC -> AACATAGACACAATTACCT
TCGTGTCTAGTTTCGGCAC -> CGTGTCTAGTTTCGGCACC
ATCCCAACCCTGAAATAAA -> TCCCAACCCTGAAATAAAT
GGTCTTGATCGCGTGATGA -> GTCTTGATCGCGTGATGAG
CTTGTCGGGATCAAGCCTA -> TTGTCGGGATCAAGCCTAT
GACTAAATTCGACTCTTCG -> ACTAAATTCGACTCTTCGC
CGGGGCACTCGTTGACCTA -> GGGGCACTCGTTGACCTAC
CATGCTATGGAGGACGGAG -> ATGCTATGGAGGACGGAGA
CTCTCCCTTGCGATTGGTT -> TCTCCCTTGCGATTGGTTG
GTAGAGCAATTGCCACTCG -> TAGAGCAATTGCCACTCGA
TTTTCCACACAAAAGCGAC -> TTTCCACACAAAAGCGACT
TTCCACACAAAAGCGACTA -> TCCACACAAAAGCGACTAG
GTTCAAGGTTTGTTGAAGT -> TTCAAGGTTTGTTGAAGTC
CCACTGCGCCGATATCCCG -> CACTGCGCCGATATCCCGG
GTAGTATTTTATGCGTTTA -> TAGTATTTTATGCGTTTAT
GTGTAAATCCCAACCCTGA -> TGTAAATCCCAACCCTGAA
TAGCCGTCAGGGTCATCCT -> AGCCGTCAGGGTCATCCTA
GACATGGGCAGGCGTCTTA -> ACATGGGCAGGCGTCTTAT
ACTCTTCGCTTTTACAAAA -> CTCTTCGCTTTTACAAAAT
CGGAATCGCGGAATTCTCC -> GGAATCGCGGAATTCTCCT
GCCTGCCCACTGCGCCGAT -> CCTGCCCACTGCGCCGATA
CTAATACGCTAGAAGAGGC -> TAATACGCTAGAAGAGGCC
TCAGGGTCATCCTAACTAT -> CAGGGTCATCCTAACTATC
AAGGTCTTGATCGCGTGAT -> AGGTCTTGATCGCGTGATG
CCCGGATACTGTAAGGACG -> CCGGATACTGTAAGGACGC
GATCCGCCAATTGCAAGAC -> ATCCGCCAATTGCAAGACA
AGAATTCAACCCCCGCGTG -> GAATTCAACCCCCGCGTGT
TTTGCCGTTAAGCTCGAGA -> TTGCCGTTAAGCTCGAGAG
TCCCAACCCTGAAATAAAT -> CCCAACCCTGAAATAAATC
TCCTATACGCGTAGCTCTC -> CCTATACGCGTAGCTCTCG
AAGCTCGAGAGCTGGCTGC -> AGCTCGAGAGCTGGCTGCG
TTTTAATCCCGGTCGTGTC -> TTTAATCCCGGTCGTGTCT
CGAATGTTAGCACATTCCG -> GAATGTTAGCACATTCCGT
ATTGGTTGCTGGTTGTACA -> TTGGTTGCTGGTTGTACAG
GAATCGTAGCGACGGGTGA -> AATCGTAGCGACGGGTGAT
GGGAGTATGCGGCGGCGAA -> GGAGTATGCGGCGGCGAAT
AGACTCCCTGCATGAAGGT -> GACTCCCTGCATGAAGGTC
ATTACATATTTTAATCCCG -> TTACATATTTTAATCCCGG
TCTGCGATGCCGGTTGTAG -> CTGCGATGCCGGTTGTAGA
GGACGATCCTGAAATTAAG -> GACGATCCTGAAATTAAGA
CAATTGCAAGACACACTTA -> AATTGCAAGACACACTTAC
GGCCTTAGCTGTTATACGC -> GCCTTAGCTGTTATACGCT
CGCCCACCGCATCCCGGTC -> GCCCACCGCATCCCGGTCG
CTCAAATGGTCCAGGCCAT -> TCAAATGGTCCAGGCCATT
GTCCAAGCATACGGACATT -> TCCAAGCATACGGACATTG
TATGCGAAAGCAGTACTAG -> ATGCGAAAGCAGTACTAGC
CCAAAACTAATCCAGTTAT -> CAAAACTAATCCAGTTATT
TCAGCAATGAGGTAGTGTC -> CAGCAATGAGGTAGTGTCG
ACCTGGGCCACTCAGGCCT -> CCTGGGCCACTCAGGCCTT
CGCGCTATGCTACCCAAGT -> GCGCTATGCTACCCAAGTG
GCAGTCGCAAATCCTTTCG -> CAGTCGCAAATCCTTTCGG
TGCAACCGCGCTATGCTAC -> GCAACCGCGCTATGCTACC
GGTTTATGGAGATGGAGCG -> GTTTATGGAGATGGAGCGT
GTTAACCAACGGCTGTGAT -> TTAACCAACGGCTGTGATC
GTTACTCCCGCAAGCATCA -> TTACTCCCGCAAGCATCAG
TCTCCTGATGTGTAAATCC -> CTCCTGATGTGTAAATCCC
ATGATTGGGTAACTTGAGA -> TGATTGGGTAACTTGAGAT
AACTATACAAAGACGCACT -> ACTATACAAAGACGCACTT
TTTGTAGAGGTGTGCGCCT -> TTGTAGAGGTGTGCGCCTC
AAGCAAGTACCATAGTACA -> AGCAAGTACCATAGTACAG
TGTAAGGACGCTCAGCTCG -> GTAAGGACGCTCAGCTCGA
GTTCGGAGCCGGTTTATGG -> TTCGGAGCCGGTTTATGGA
GCACGTGTCGACACTGGAT -> CACGTGTCGACACTGGATT
CCTCCGGCTTTAGCCGTCA -> CTCCGGCTTTAGCCGTCAG
GAATACTGCTTATCTTGCA -> AATACTGCTTATCTTGCAC
CTAGTGCACTAATACGCTA -> TAGTGCACTAATACGCTAG
GATGGTACCTTTAGTCAGT -> ATGGTACCTTTAGTCAGTT
CTGGATTCTCGGGTTTTCC -> TGGATTCTCGGGTTTTCCA
AGAAGAGGCCCTCCGGCGG -> GAAGAGGCCCTCCGGCGGA
CTTGGATGTTTGCCGTTAA -> TTGGATGTTTGCCGTTAAG
CTTAAGTTATTCGGCGATT -> TTAAGTTATTCGGCGATTG
GTACAGAACTGCAGGGGCA -> TACAGAACTGCAGGGGCAC
AACGGCTGCGGGACGATCC -> ACGGCTGCGGGACGATCCT
TACCCAAGTGGCTTGCTCA -> ACCCAAGTGGCTTGCTCAT
ATTTCTGAGTAGTTGACCC -> TTTCTGAGTAGTTGACCCT
TTCTCGGGTTTTCCACACA -> TCTCGGGTTTTCCACACAA
GCCCTGAACTCTAAAAAAC -> CCCTGAACTCTAAAAAACT
GTGATGAGAAGGCCAGATC -> TGATGAGAAGGCCAGATCC
CTGCGCCCACCGCATCCCG -> TGCGCCCACCGCATCCCGG
ACGCGTCTGCAACCGCGCT -> CGCGTCTGCAACCGCGCTA
CTTGCGAATACCTTCATTT -> TTGCGAATACCTTCATTTC
CATTTCGTAGACTAAATTC -> ATTTCGTAGACTAAATTCG
TAACTTGAGATATCTAATC -> AACTTGAGATATCTAATCG
ATTCCGTCCAAGAGAGGGA -> TTCCGTCCAAGAGAGGGAC
CGCAAAATGCTCGCTAATG -> GCAAAATGCTCGCTAATGC
GTCAGGGTCATCCTAACTA -> TCAGGGTCATCCTAACTAT
CAGGGTGCGTTACGTGATT -> AGGGTGCGTTACGTGATTT
GCAATGAGGTAGTGTCGAC -> CAATGAGGTAGTGTCGACC
AGAGCGTGAGGCACTTCCA -> GAGCGTGAGGCACTTCCAA
AGCTACCCGGATACTGTAA -> GCTACCCGGATACTGTAAG
TTTGTTGAAGTCGCAAACG -> TTGTTGAAGTCGCAAACGG
GGTGTGCCTCTTCACGCAT -> GTGTGCCTCTTCACGCATT
TGAATACTGCTTATCTTGC -> GAATACTGCTTATCTTGCA
TGGATTCTCGGGTTTTCCA -> GGATTCTCGGGTTTTCCAC
CTGAACTCTAAAAAACTAC -> TGAACTCTAAAAAACTACC
TGTCTAGTCCTATTGTATG -> GTCTAGTCCTATTGTATGC
CCTCATCAGCAATGAGGTA -> CTCATCAGCAATGAGGTAG
TATCTAATCGCTGCATCGA -> ATCTAATCGCTGCATCGAA
TCGGCGATTGGCATTACAT -> CGGCGATTGGCATTACATA
GGTCGTGTCTAGTCCTATT -> GTCGTGTCTAGTCCTATTG
CTAGTAAGCTTTTTAGCTA -> TAGTAAGCTTTTTAGCTAG
CCAACGGCTGTGATCCAAA -> CAACGGCTGTGATCCAAAA
TATTTAGTGGCACAATTGT -> ATTTAGTGGCACAATTGTC
GTTATTGCCGTGGGCATCG -> TTATTGCCGTGGGCATCGA
AAGCATACGGACATTGGTG -> AGCATACGGACATTGGTGT
ATCAGCAATGAGGTAGTGT -> TCAGCAATGAGGTAGTGTC
TGACCCTTTTCCGGCTTGT -> GACCCTTTTCCGGCTTGTC
ATGGTATTACTCCGGCGCA -> TGGTATTACTCCGGCGCAA
GGAGACTCCCTGCATGAAG -> GAGACTCCCTGCATGAAGG
ATTAACATAGACACAATTA -> TTAACATAGACACAATTAC
TCCACACAAAAGCGACTAG -> CCACACAAAAGCGACTAGT
CATTTCTTTAGTTCCCGAT -> ATTTCTTTAGTTCCCGATG
AGTGTCGACCAAATCGCAC -> GTGTCGACCAAATCGCACA
GGCTGCGGGACGATCCTGA -> GCTGCGGGACGATCCTGAA
GAACCCAATGTTAACCAAC -> AACCCAATGTTAACCAACG
GGTTTGTTGAAGTCGCAAA -> GTTTGTTGAAGTCGCAAAC
TGTTGTTGTATACAAAAGG -> GTTGTTGTATACAAAAGGA
CGTAGACTAAATTCGACTC -> GTAGACTAAATTCGACTCT
CCTGGGCCACTCAGGCCTT -> CTGGGCCACTCAGGCCTTA
TCGGAGCCGGTTTATGGAG -> CGGAGCCGGTTTATGGAGA
CTGTTATACGCTGCACGTT -> TGTTATACGCTGCACGTTT
AGATGGAGCGTAGCCCCTA -> GATGGAGCGTAGCCCCTAA
GAGCGTAGCCCCTAATAAT -> AGCGTAGCCCCTAATAATA
GCCGTCAGGGTCATCCTAA -> CCGTCAGGGTCATCCTAAC
ATCAAGCCTATAAACGTCC -> TCAAGCCTATAAACGTCCC
CTCAGGACGGCATGGTATT -> TCAGGACGGCATGGTATTA
GGTCTGTGAAACTATACAA -> GTCTGTGAAACTATACAAA
CGGCAAGTGGACTTTGTTG -> GGCAAGTGGACTTTGTTGT
AAACAACTGAACAGTAAAC -> AACAACTGAACAGTAAACG
AGGCACTTCCAATCCCTGT -> GGCACTTCCAATCCCTGTA
TATTTTCATTGATCCCGGT -> ATTTTCATTGATCCCGGTC
CCTTTTCCGGCTTGTCGGG -> CTTTTCCGGCTTGTCGGGA
GAGTTTACATAGGCTCTCC -> AGTTTACATAGGCTCTCCC
TCGACACTGGATTCTCGGG -> CGACACTGGATTCTCGGGT
ATTTCTTTAGTTCCCGATG -> TTTCTTTAGTTCCCGATGA
GCCAGCCGCCGGGTCTGTG -> CCAGCCGCCGGGTCTGTGA
GGTAACTTGAGATATCTAA -> GTAACTTGAGATATCTAAT
CGAATCGTAGCGACGGGTG -> GAATCGTAGCGACGGGTGA
CTCTTCGCTTTTACAAAAT -> TCTTCGCTTTTACAAAATT
TCTCCCTTGCGATTGGTTG -> CTCCCTTGCGATTGGTTGC
GAACTCTAAAAAACTACCC -> AACTCTAAAAAACTACCCT
CAACTGAACAGTAAACGAA -> AACTGAACAGTAAACGAAC
TAGTTTCGGCACCAACTAG -> AGTTTCGGCACCAACTAGA
GCATGAAGGTCTTGATCGC -> CATGAAGGTCTTGATCGCG
CGCAAACGGCTGCGGGACG -> GCAAACGGCTGCGGGACGA
CTAGTTTCAGATAGCACCC -> TAGTTTCAGATAGCACCCG
AGACACACTTACTCATGTC -> GACACACTTACTCATGTCC
TCGATTTCTGCGATGCCGG -> CGATTTCTGCGATGCCGGT
AGAAGAGGCCCTCCGGCAA -> GAAGAGGCCCTCCGGCAAG
TTAGTGGCACAATTGTCTA -> TAGTGGCACAATTGTCTAT
GGCATGGGCGGAAAGCTTA -> GCATGGGCGGAAAGCTTAC
CTCATCAGCAATGAGGTAG -> TCATCAGCAATGAGGTAGT
CGCAAATCCTTTCGGGGGC -> GCAAATCCTTTCGGGGGCA
ACCATCTAAGCTGCAAGTC -> CCATCTAAGCTGCAAGTCA
CAACCCCCGCGTGTGGGGC -> AACCCCCGCGTGTGGGGCC
GAGGCCCTCCGGCAAGTGG -> AGGCCCTCCGGCAAGTGGA
GACGGCATGGTATTACTCC -> ACGGCATGGTATTACTCCG
GGCACGTGTCGACACTGGA -> GCACGTGTCGACACTGGAT
TGTCTTGTAGGGCATGGGC -> GTCTTGTAGGGCATGGGCG
AATTGTTGTTTCCGCCAGC -> ATTGTTGTTTCCGCCAGCC
GAGCGTGAGGCACTTCCAA -> AGCGTGAGGCACTTCCAAT
CCGCCAGCCGCCGGGTCTG -> CGCCAGCCGCCGGGTCTGT
GTTAAGCTCGAGAGCTGGC -> TTAAGCTCGAGAGCTGGCT
GCAAGACACACTTACTCAT -> CAAGACACACTTACTCATG
ATCGCGGAATTCTCCTGAT -> TCGCGGAATTCTCCTGATG
CATTCCGTCCAAGAGAGGG -> ATTCCGTCCAAGAGAGGGA
CCTCTTCACGCATTAGTGG -> CTCTTCACGCATTAGTGGC
GCGTGATGAGAAGGCCAGA -> CGTGATGAGAAGGCCAGAT
TTTAGTGGCACAATTGTCT -> TTAGTGGCACAATTGTCTA
CGGTCGTGTCTAGTCCTAT -> GGTCGTGTCTAGTCCTATT
CGAAGAGCCTGCCCACTGC -> GAAGAGCCTGCCCACTGCG
CTCCGGCTTTAGCCGTCAG -> TCCGGCTTTAGCCGTCAGG
GTCGACCAAATCGCACATA -> TCGACCAAATCGCACATAT
TTTCGTGTAGAGCAATTGC -> TTCGTGTAGAGCAATTGCC
CCCAAGTGGCTTGCTCATC -> CCAAGTGGCTTGCTCATCA
CGCTATGCTACCCAAGTGG -> GCTATGCTACCCAAGTGGC
AGAAGAGGCCCTCCGGCTT -> GAAGAGGCCCTCCGGCTTT
AGTCGCAAACGGCTGCGGG -> GTCGCAAACGGCTGCGGGA
AAAAGCGACTAGTTTCAGA -> AAAGCGACTAGTTTCAGAT
TCCTAAAAGAGTACGCAAT -> CCTAAAAGAGTACGCAATT
GGGGAGACTCCCTGCATGA -> GGGAGACTCCCTGCATGAA
CAATGATTGGGTAACTTGA -> AATGATTGGGTAACTTGAG
GTTATTCGGCGATTGGCAT -> TTATTCGGCGATTGGCATT
TCACGCATTAGTGGCGCTA -> CACGCATTAGTGGCGCTAT
TAAATCGCGAAGAGCCTGC -> AAATCGCGAAGAGCCTGCC
TAGCTGTTATACGCTGCAC -> AGCTGTTATACGCTGCACG
CAAAATGCTCGCTAATGCA -> AAAATGCTCGCTAATGCAG
ACATATTTTAATCCCGGTC -> CATATTTTAATCCCGGTCG
AAAAAACTACCCTATTGGG -> AAAAACTACCCTATTGGGG
ACCAAATCGCACATATGTT -> CCAAATCGCACATATGTTT
GCATGGGCGGAAAGCTTAC -> CATGGGCGGAAAGCTTACT
GGGCCACTCAGGCCTTAGC -> GGCCACTCAGGCCTTAGCT
CAGCCGCCGGGTCTGTGAA -> AGCCGCCGGGTCTGTGAAA
GGCACTCGTTGACCTACCT -> GCACTCGTTGACCTACCTG
GGGGACTTCCTAAAAGAGT -> GGGACTTCCTAAAAGAGTA
GCGTGTGGGGCCAGGACAT -> CGTGTGGGGCCAGGACATG
TACAGAACTGCAGGGGCAC -> ACAGAACTGCAGGGGCACG
CCGGTTGTAGAATTCAACC -> CGGTTGTAGAATTCAACCC
GAGCTGGCTGCGCCCACCG -> AGCTGGCTGCGCCCACCGC
GGAGACGAACTGTCCAAGC -> GAGACGAACTGTCCAAGCA
GCGTCTTATTTTCATTGAT -> CGTCTTATTTTCATTGATC
AGTGGCACAATTGTCTATT -> GTGGCACAATTGTCTATTT
CCCTCCGGCTTTAGCCGTC -> CCTCCGGCTTTAGCCGTCA
AGAAATCCGTAGGAGCTAC -> GAAATCCGTAGGAGCTACC
ACGGGTGATATAACGTTAC -> CGGGTGATATAACGTTACT
GGTGCGTTACGTGATTTAA -> GTGCGTTACGTGATTTAAT
TGAACTCTAAAAAACTACC -> GAACTCTAAAAAACTACCC
TACATGTTTGACCATCTAA -> ACATGTTTGACCATCTAAG
TACGCGTAGCTCTCGTGCC -> ACGCGTAGCTCTCGTGCCG
TTAGTCAGTTAGTAGTATT -> TAGTCAGTTAGTAGTATTT
GTGCACTAATACGCTAGAA -> TGCACTAATACGCTAGAAG
CCGTCGGTCCAGGCTTCTC -> CGTCGGTCCAGGCTTCTCA
GAGATGGAGCGTAGCCCCT -> AGATGGAGCGTAGCCCCTA
CGAAGCCTTGGATGTTTGC -> GAAGCCTTGGATGTTTGCC
TTGTATGCTAGAAGAGGCC -> TGTATGCTAGAAGAGGCCC
GCATCGATTTCTGCGATGC -> CATCGATTTCTGCGATGCC
CCTCCGCTTATGCGAAAGC -> CTCCGCTTATGCGAAAGCA
AAATTCGACTCTTCGCTTT -> AATTCGACTCTTCGCTTTT
TAGACCAGGCAATGGGAAC -> AGACCAGGCAATGGGAACC
ATCTTGCACGATCCGCCAA -> TCTTGCACGATCCGCCAAT
AGTTTGTAGAGGTGTGCGC -> GTTTGTAGAGGTGTGCGCC
CCTGGTGAGGTCTTACTAT -> CTGGTGAGGTCTTACTATT
ACTAGTTTCAGATAGCACC -> CTAGTTTCAGATAGCACCC
TTTTCATTGATCCCGGTCG -> TTTCATTGATCCCGGTCGT
CAACGGCTGTGATCCAAAA -> AACGGCTGTGATCCAAAAC
GCTATGCTACCCAAGTGGC -> CTATGCTACCCAAGTGGCT
ACCCAATGTTAACCAACGG -> CCCAATGTTAACCAACGGC
TTGCAAGACACACTTACTC -> TGCAAGACACACTTACTCA
TCGCGTGATGAGAAGGCCA -> CGCGTGATGAGAAGGCCAG
ATCGCGAAGAGCCTGCCCA -> TCGCGAAGAGCCTGCCCAC
GATCCCGGTCGTGTCTAGT -> ATCCCGGTCGTGTCTAGTG
CTTACTCATGTCCTGCCAA -> TTACTCATGTCCTGCCAAC
TCCGGCAAGTGGACTTTGT -> CCGGCAAGTGGACTTTGTT
TTGGGGAGACTCCCTGCAT -> TGGGGAGACTCCCTGCATG
TAAAATTTATTCCCGACAT -> AAAATTTATTCCCGACATT
CATCCTAACTATCCTATAC -> ATCCTAACTATCCTATACG
GCTTTTACAAAATTAGCGA -> CTTTTACAAAATTAGCGAT
GGCCAGATCCGAGTTTACA -> GCCAGATCCGAGTTTACAT
GGCAAGTGGACTTTGTTGT -> GCAAGTGGACTTTGTTGTT
GATCCAAAACTAATCCAGT -> ATCCAAAACTAATCCAGTT
CGCGAAGAGCCTGCCCACT -> GCGAAGAGCCTGCCCACTG
GCATCAGGATGCAGTCGCA -> CATCAGGATGCAGTCGCAA
CATACGGACATTGGTGTCT -> ATACGGACATTGGTGTCTT
ATATGTTTCGTCGAAGAGC -> TATGTTTCGTCGAAGAGCG
CACTACCATTGCTTAAGTT -> ACTACCATTGCTTAAGTTA
AAGGCCAGATCCGAGTTTA -> AGGCCAGATCCGAGTTTAC
AATTATGTGGCGAATGTTA -> ATTATGTGGCGAATGTTAG
TTCGTCCACAAGGAGCCGG -> TCGTCCACAAGGAGCCGGC
ATATGTCATACTTGGGTGT -> TATGTCATACTTGGGTGTG
GCGGAAAGCTTACTGAAAT -> CGGAAAGCTTACTGAAATT
ACGGAGACGAACTGTCCAA -> CGGAGACGAACTGTCCAAG
GAGGGACTCAAATGGTCCA -> AGGGACTCAAATGGTCCAG
TAGCCCCTAATAATAAATC -> AGCCCCTAATAATAAATCT
ATGGAGCGTAGCCCCTAAT -> TGGAGCGTAGCCCCTAATA
GTAGCGACGGGTGATATAA -> TAGCGACGGGTGATATAAC
CTAATCCAGTTATTGCCGT -> TAATCCAGTTATTGCCGTG
ACTAATCCAGTTATTGCCG -> CTAATCCAGTTATTGCCGT
AACGAACTGTGAGGATAAA -> ACGAACTGTGAGGATAAAG
ATAAATCGCGAAGAGCCTG -> TAAATCGCGAAGAGCCTGC
CTAACTATCCTATACGCGT -> TAACTATCCTATACGCGTA
GTTTCGGCACCAACTAGAA -> TTTCGGCACCAACTAGAAG
GGACTCAGGACGGCATGGT -> GACTCAGGACGGCATGGTA
AAGCCTATAAACGTCCCGT -> AGCCTATAAACGTCCCGTC
ATTGCAAGACACACTTACT -> TTGCAAGACACACTTACTC
TTAGCGATGGTACCTTTAG -> TAGCGATGGTACCTTTAGT
CACGTCGAGCCTCCGCTTA -> ACGTCGAGCCTCCGCTTAT
GTCCAGGCCATTTCTTTAG -> TCCAGGCCATTTCTTTAGT
GTTTACATAGGCTCTCCCT -> TTTACATAGGCTCTCCCTT
TGTGCCTCTTCACGCATTA -> GTGCCTCTTCACGCATTAG
GATCCTGAAATTAAGAAAT -> ATCCTGAAATTAAGAAATC
GTTATACGCTGCACGTTTA -> TTATACGCTGCACGTTTAC
AGAGAGGGACTCAAATGGT -> GAGAGGGACTCAAATGGTC
TGATCCAAAACTAATCCAG -> GATCCAAAACTAATCCAGT
TCTTCGCTTTTACAAAATT -> CTTCGCTTTTACAAAATTA
AATACGCTAGAAGAGGCCC -> ATACGCTAGAAGAGGCCCT
GATCCGAGTTTACATAGGC -> ATCCGAGTTTACATAGGCT
ATTGCTTAAGTTATTCGGC -> TTGCTTAAGTTATTCGGCG
CACGCATTAGTGGCGCTAT -> ACGCATTAGTGGCGCTATT
TGAAATTAAGAAATCCGTA -> GAAATTAAGAAATCCGTAG
AGCATTGAATACTGCTTAT -> GCATTGAATACTGCTTATC
CTGGTGAGGTCTTACTATT -> TGGTGAGGTCTTACTATTA
GTGGCGAATGTTAGCACAT -> TGGCGAATGTTAGCACATT
ATCTAATCGCTGCATCGAA -> TCTAATCGCTGCATCGAAG
TTGGGTGTGCCTCTTCACG -> TGGGTGTGCCTCTTCACGC
AATAAATCGCGAAGAGCCT -> ATAAATCGCGAAGAGCCTG
AACTGTCCAAGCATACGGA -> ACTGTCCAAGCATACGGAC
CATCAGGATGCAGTCGCAA -> ATCAGGATGCAGTCGCAAA
GTTTCAGATAGCACCCGCA -> TTTCAGATAGCACCCGCAC
TAGGGCATGGGCGGAAAGC -> AGGGCATGGGCGGAAAGCT
AAGCGTACCTGGTGAGGTC -> AGCGTACCTGGTGAGGTCT
GTTCCCGATGAAGCAAGTA -> TTCCCGATGAAGCAAGTAC
ATTTTAATCCCGGTCGTGT -> TTTTAATCCCGGTCGTGTC
CTCTCGTGCCGTCGGTCCA -> TCTCGTGCCGTCGGTCCAG
CAGGCCTTAGCTGTTATAC -> AGGCCTTAGCTGTTATACG
CGTCGGTCACTCGGGGAGT -> GTCGGTCACTCGGGGAGTA
CCGTGGGCATCGATTTCTG -> CGTGGGCATCGATTTCTGC
ATGAGGTAGTGTCGACCAA -> TGAGGTAGTGTCGACCAAA
AGCTAGAAGAGGCCCTCCG -> GCTAGAAGAGGCCCTCCGG
CGGGTCTGTGAAACTATAC -> GGGTCTGTGAAACTATACA
GCCCTCCGGCAAGTGGACT -> CCCTCCGGCAAGTGGACTT
CGGCGGCGAATCGTAGCGA -> GGCGGCGAATCGTAGCGAC
GGCATCGATTTCTGCGATG -> GCATCGATTTCTGCGATGC
GGGACTTCCTAAAAGAGTA -> GGACTTCCTAAAAGAGTAC
CGCTGCACGTTTACATGTT -> GCTGCACGTTTACATGTTT
AATGCTCGCTAATGCAGAC -> ATGCTCGCTAATGCAGACG
CACGTGTCGACACTGGATT -> ACGTGTCGACACTGGATTC
GTCTATTTCGTGTAGAGCA -> TCTATTTCGTGTAGAGCAA
GATATCCCGGTCGTGTCTA -> ATATCCCGGTCGTGTCTAG
CCCCCGCGTGTGGGGCCAG -> CCCCGCGTGTGGGGCCAGG
TTGTTGTTTCCGCCAGCCG -> TGTTGTTTCCGCCAGCCGC
GAACAGTAAACGAACTGTG -> AACAGTAAACGAACTGTGA
AATGTTAACCAACGGCTGT -> ATGTTAACCAACGGCTGTG
GGTGTCTTGTAGGGCATGG -> GTGTCTTGTAGGGCATGGG
TGGATGTTTGCCGTTAAGC -> GGATGTTTGCCGTTAAGCT
TTACTCCGGCGCAAAATGC -> TACTCCGGCGCAAAATGCT
CGTGCCGTCGGTCCAGGCT -> GTGCCGTCGGTCCAGGCTT
ACACTTACTCATGTCCTGC -> CACTTACTCATGTCCTGCC
CCCTCCGGCCCACCCAGTT -> CCTCCGGCCCACCCAGTTC
TTCTCCTGATGTGTAAATC -> TCTCCTGATGTGTAAATCC
CATCGATTTCTGCGATGCC -> ATCGATTTCTGCGATGCCG
TATACAAAGACGCACTTAG -> ATACAAAGACGCACTTAGA
TGGTTGTACAGCAAACAAC -> GGTTGTACAGCAAACAACT
GGTGATATAACGTTACTCC -> GTGATATAACGTTACTCCC
GGGAACCCAATGTTAACCA -> GGAACCCAATGTTAACCAA
AAAACTACCCTATTGGGGA -> AAACTACCCTATTGGGGAC
GATTGGCATTACATATTTT -> ATTGGCATTACATATTTTA
AATCCCGGTCGTGTCTAGT -> ATCCCGGTCGTGTCTAGTA
CTTCACGCATTAGTGGCGC -> TTCACGCATTAGTGGCGCT
CGTGTGGGGCCAGGACATG -> GTGTGGGGCCAGGACATGG
TTTACATAGGCTCTCCCTT -> TTACATAGGCTCTCCCTTG
GCACTAATACGCTAGAAGA -> CACTAATACGCTAGAAGAG
GGAGGGGCAGGGTGCGTTA -> GAGGGGCAGGGTGCGTTAC
AAAGCTTACTGAAATTAGT -> AAGCTTACTGAAATTAGTT
AAATTTATTCCCGACATTT -> AATTTATTCCCGACATTTC
AGCATACGGACATTGGTGT -> GCATACGGACATTGGTGTC
TCCTATTGTATGCTAGAAG -> CCTATTGTATGCTAGAAGA
AGAGCAATTGCCACTCGAT -> GAGCAATTGCCACTCGATA
ACTCAGGCCTTAGCTGTTA -> CTCAGGCCTTAGCTGTTAT
ATAAACGTCCCGTCGGTCA -> TAAACGTCCCGTCGGTCAC
TTGACCTACCTGGGCCACT -> TGACCTACCTGGGCCACTC
TTCTGCGATGCCGGTTGTA -> TCTGCGATGCCGGTTGTAG
CGTAGCCCCTAATAATAAA -> GTAGCCCCTAATAATAAAT
CTGTGAGGATAAAGCGTAC -> TGTGAGGATAAAGCGTACC
CTATTAACATAGACACAAT -> TATTAACATAGACACAATT
CGGCTGTGATCCAAAACTA -> GGCTGTGATCCAAAACTAA
CGGGGGCATCGGGGCACTC -> GGGGGCATCGGGGCACTCG
GCGAAAGCAGTACTAGCCC -> CGAAAGCAGTACTAGCCCA
ACCAGGCAATGGGAACCCA -> CCAGGCAATGGGAACCCAA
TCTCGTGCCGTCGGTCCAG -> CTCGTGCCGTCGGTCCAGG
GATCAAGCCTATAAACGTC -> ATCAAGCCTATAAACGTCC
ATTGTCTATTTCGTGTAGA -> TTGTCTATTTCGTGTAGAG
GTTTGACCATCTAAGCTGC -> TTTGACCATCTAAGCTGCA
TTACTCCCGCAAGCATCAG -> TACTCCCGCAAGCATCAGG
AGACGCACTTAGACCAGGC -> GACGCACTTAGACCAGGCA
ATACGGACATTGGTGTCTT -> TACGGACATTGGTGTCTTG
GGCCCTCCGGCAAGTGGAC -> GCCCTCCGGCAAGTGGACT
AGGCCCTCCGGCAAGTGGA -> GGCCCTCCGGCAAGTGGAC
TTCCGGCTTGTCGGGATCA -> TCCGGCTTGTCGGGATCAA
CAAGACACACTTACTCATG -> AAGACACACTTACTCATGT
CTCGAGAGCTGGCTGCGCC -> TCGAGAGCTGGCTGCGCCC
GACGCGTCTGCAACCGCGC -> ACGCGTCTGCAACCGCGCT
CGAACTGTGAGGATAAAGC -> GAACTGTGAGGATAAAGCG
TTTATTCCCGACATTTCGT -> TTATTCCCGACATTTCGTA
GCTGGTTGTACAGCAAACA -> CTGGTTGTACAGCAAACAA
GGTCGTGTCTAGTGCACTA -> GTCGTGTCTAGTGCACTAA
ATCCTTTCGGGGGCATCGG -> TCCTTTCGGGGGCATCGGG
AAGAAATCCGTAGGAGCTA -> AGAAATCCGTAGGAGCTAC
TTGCTCATCATGCTATGGA -> TGCTCATCATGCTATGGAG
AGACACAATTACCTCTACG -> GACACAATTACCTCTACGG
TCACAGAATTATGTGGCGA -> CACAGAATTATGTGGCGAA
ATAGCACCCGCACTACCAT -> TAGCACCCGCACTACCATT
AATGAGGTAGTGTCGACCA -> ATGAGGTAGTGTCGACCAA
CCGGCTTTAGCCGTCAGGG -> CGGCTTTAGCCGTCAGGGT
ATGTTAACCAACGGCTGTG -> TGTTAACCAACGGCTGTGA
GACGATCCTGAAATTAAGA -> ACGATCCTGAAATTAAGAA
GTCTGTGAAACTATACAAA -> TCTGTGAAACTATACAAAG
CTAATCGCTGCATCGAAGC -> TAATCGCTGCATCGAAGCC
TTGGTGTCTTGTAGGGCAT -> TGGTGTCTTGTAGGGCATG
CCCGATGAAGCAAGTACCA -> CCGATGAAGCAAGTACCAT
TACAGCAAACAACTGAACA -> ACAGCAAACAACTGAACAG
CCGCGTGTGGGGCCAGGAC -> CGCGTGTGGGGCCAGGACA
AACTGAACAGTAAACGAAC -> ACTGAACAGTAAACGAACT
CTGCCCACTGCGCCGATAT -> TGCCCACTGCGCCGATATC
GAGAGGGACTCAAATGGTC -> AGAGGGACTCAAATGGTCC
GCAAAATGCTCGCTAATGC -> CAAAATGCTCGCTAATGCA
GTTTCCGCCAGCCGCCGGG -> TTTCCGCCAGCCGCCGGGT
TATGCTAGAAGAGGCCCTC -> ATGCTAGAAGAGGCCCTCC
TTTTAGCTAGAAGAGGCCC -> TTTAGCTAGAAGAGGCCCT
CGGCCCTGAACTCTAAAAA -> GGCCCTGAACTCTAAAAAA
CTCGACACGGCCCTGAACT -> TCGACACGGCCCTGAACTC
CCTAAAAGAGTACGCAATT -> CTAAAAGAGTACGCAATTG
GTCGCAAATCCTTTCGGGG -> TCGCAAATCCTTTCGGGGG
CACTGGATTCTCGGGTTTT -> ACTGGATTCTCGGGTTTTC
TAGTACAGAACTGCAGGGG -> AGTACAGAACTGCAGGGGC
AGGCCTTAGCTGTTATACG -> GGCCTTAGCTGTTATACGC
TAAAAGAGTACGCAATTGT -> AAAAGAGTACGCAATTGTT
CACTTACTCATGTCCTGCC -> ACTTACTCATGTCCTGCCA
AACCCAATGTTAACCAACG -> ACCCAATGTTAACCAACGG
AGGAGCCGGCTTGCGAATA -> GGAGCCGGCTTGCGAATAC
GCACAATTGTCTATTTCGT -> CACAATTGTCTATTTCGTG
GTCGTGTCTAGTCCTATTG -> TCGTGTCTAGTCCTATTGT
AACAGTAAACGAACTGTGA -> ACAGTAAACGAACTGTGAG
GACACTGGATTCTCGGGTT -> ACACTGGATTCTCGGGTTT
ATTCCTCATCAGCAATGAG -> TTCCTCATCAGCAATGAGG
ATTGAATACTGCTTATCTT -> TTGAATACTGCTTATCTTG
CTACCCTATTGGGGACTTC -> TACCCTATTGGGGACTTCC
TTGAATACTGCTTATCTTG -> TGAATACTGCTTATCTTGC
TTATCTTGCACGATCCGCC -> TATCTTGCACGATCCGCCA
TTGCCGTGGGCATCGATTT -> TGCCGTGGGCATCGATTTC
TCATGTCCTGCCAACGGAA -> CATGTCCTGCCAACGGAAT
TTGTTGTTGTATACAAAAG -> TGTTGTTGTATACAAAAGG
CTGGGCCACTCAGGCCTTA -> TGGGCCACTCAGGCCTTAG
AATTAGTTTGTAGAGGTGT -> ATTAGTTTGTAGAGGTGTG
TAGTAAGCTTTTTAGCTAG -> AGTAAGCTTTTTAGCTAGA
GTCATCCTAACTATCCTAT -> TCATCCTAACTATCCTATA
CCACTCAGGCCTTAGCTGT -> CACTCAGGCCTTAGCTGTT
GTGTGGGGCCAGGACATGG -> TGTGGGGCCAGGACATGGG
CACAATTACCTCTACGGTT -> ACAATTACCTCTACGGTTC
GAAGGTCTTGATCGCGTGA -> AAGGTCTTGATCGCGTGAT
ACACACTTACTCATGTCCT -> CACACTTACTCATGTCCTG
CGGCGCAAAATGCTCGCTA -> GGCGCAAAATGCTCGCTAA
GGAATGTTCAAGGTTTGTT -> GAATGTTCAAGGTTTGTTG
GGCACCAACTAGAAGAGGC -> GCACCAACTAGAAGAGGCC
GAAATAAATCGCGAAGAGC -> AAATAAATCGCGAAGAGCC
AATATTGGGGAGACTCCCT -> ATATTGGGGAGACTCCCTG
AAGGAGCCGGCTTGCGAAT -> AGGAGCCGGCTTGCGAATA
CCAACCCTGAAATAAATCG -> CAACCCTGAAATAAATCGC
ACTCGGGGAGTATGCGGCG -> CTCGGGGAGTATGCGGCGG
TAATAAATCTTATACCACG -> AATAAATCTTATACCACGT
CTTCCAATCCCTGTAGCAA -> TTCCAATCCCTGTAGCAAT
GTGGCTTGCTCATCATGCT -> TGGCTTGCTCATCATGCTA
AAGCCTTGGATGTTTGCCG -> AGCCTTGGATGTTTGCCGT
ATGCAGTCGCAAATCCTTT -> TGCAGTCGCAAATCCTTTC
TAGTGCACTAATACGCTAG -> AGTGCACTAATACGCTAGA
TTATGCGTTTATTTAGTGG -> TATGCGTTTATTTAGTGGC
ACCGCATCCCGGTCGTGTC -> CCGCATCCCGGTCGTGTCT
ATGTTAGCACATTCCGTCC -> TGTTAGCACATTCCGTCCA
ACAATTGTCTATTTCGTGT -> CAATTGTCTATTTCGTGTA
GGCTCTCCCTTGCGATTGG -> GCTCTCCCTTGCGATTGGT
TGCATGAAGGTCTTGATCG -> GCATGAAGGTCTTGATCGC
TCGGGGGCATCGGGGCACT -> CGGGGGCATCGGGGCACTC
GTCTAGTTTCGGCACCAAC -> TCTAGTTTCGGCACCAACT
ACGGCATGGTATTACTCCG -> CGGCATGGTATTACTCCGG
TTCGCTTTTACAAAATTAG -> TCGCTTTTACAAAATTAGC
ACTGCAGGGGCACGTGTCG -> CTGCAGGGGCACGTGTCGA
TCGCTGCATCGAAGCCTTG -> CGCTGCATCGAAGCCTTGG
GGATAAAGCGTACCTGGTG -> GATAAAGCGTACCTGGTGA
AAGAGGCCCTCCGGCGGAG -> AGAGGCCCTCCGGCGGAGG
GTCGGGATCAAGCCTATAA -> TCGGGATCAAGCCTATAAA
AGAGGGACTCAAATGGTCC -> GAGGGACTCAAATGGTCCA
TCCGGCTTGTCGGGATCAA -> CCGGCTTGTCGGGATCAAG
AGTGGCGCTATTAACATAG -> GTGGCGCTATTAACATAGA
GCTTGCTCATCATGCTATG -> CTTGCTCATCATGCTATGG
ATGTTCAAGGTTTGTTGAA -> TGTTCAAGGTTTGTTGAAG
CATGGTATTACTCCGGCGC -> ATGGTATTACTCCGGCGCA
TCCAAAACTAATCCAGTTA -> CCAAAACTAATCCAGTTAT
CAGGCTTCTCATCTTTCAA -> AGGCTTCTCATCTTTCAAC
AAACGTCCCGTCGGTCACT -> AACGTCCCGTCGGTCACTC
CAGGGGCACGTGTCGACAC -> AGGGGCACGTGTCGACACT
GGAGCCGGCTTGCGAATAC -> GAGCCGGCTTGCGAATACC
GGCTTTAGCCGTCAGGGTC -> GCTTTAGCCGTCAGGGTCA
GCACATATGTTTCGTCGAA -> CACATATGTTTCGTCGAAG
TTATGGAGATGGAGCGTAG -> TATGGAGATGGAGCGTAGC
CGGCTTGCGAATACCTTCA -> GGCTTGCGAATACCTTCAT
GTCGTGTCTAGTTTCGGCA -> TCGTGTCTAGTTTCGGCAC
GAAGAGCCTGCCCACTGCG -> AAGAGCCTGCCCACTGCGC
GGACGGAGACGAACTGTCC -> GACGGAGACGAACTGTCCA
TAGTTCCCGATGAAGCAAG -> AGTTCCCGATGAAGCAAGT
TGCCTCTTCACGCATTAGT -> GCCTCTTCACGCATTAGTG
ATCCAGTTATTGCCGTGGG -> TCCAGTTATTGCCGTGGGC
CCTATTGGGGACTTCCTAA -> CTATTGGGGACTTCCTAAA
TGCATCGAAGCCTTGGATG -> GCATCGAAGCCTTGGATGT
CGTTAAGCTCGAGAGCTGG -> GTTAAGCTCGAGAGCTGGC
ATGCTAGAAGAGGCCCTCC -> TGCTAGAAGAGGCCCTCCG
GACACACTTACTCATGTCC -> ACACACTTACTCATGTCCT
GCTTGCGAATACCTTCATT -> CTTGCGAATACCTTCATTT
ATGCAGACGCGTCTGCAAC -> TGCAGACGCGTCTGCAACC
GTTGTTGTATACAAAAGGA -> TTGTTGTATACAAAAGGAC
CGTTTACATGTTTGACCAT -> GTTTACATGTTTGACCATC
GGTCCAGGCTTCTCATCTT -> GTCCAGGCTTCTCATCTTT
TGGTGAGGTCTTACTATTA -> GGTGAGGTCTTACTATTAA
ATCCCTGTAGCAATGATTG -> TCCCTGTAGCAATGATTGG
GACATTGGTGTCTTGTAGG -> ACATTGGTGTCTTGTAGGG
AATTAAGAAATCCGTAGGA -> ATTAAGAAATCCGTAGGAG
GTCGAAGAGCGTGAGGCAC -> TCGAAGAGCGTGAGGCACT
TTACTGAAATTAGTTTGTA -> TACTGAAATTAGTTTGTAG
CCAAGTGGCTTGCTCATCA -> CAAGTGGCTTGCTCATCAT
TAGCACCCGCACTACCATT -> AGCACCCGCACTACCATTG
GCAATTGTTGTTTCCGCCA -> CAATTGTTGTTTCCGCCAG
AATCCAGTTATTGCCGTGG -> ATCCAGTTATTGCCGTGGG
TGAAGTCGCAAACGGCTGC -> GAAGTCGCAAACGGCTGCG
ATGAAGGTCTTGATCGCGT -> TGAAGGTCTTGATCGCGTG
GAATTCAACCCCCGCGTGT -> AATTCAACCCCCGCGTGTG
TCGACTCTTCGCTTTTACA -> CGACTCTTCGCTTTTACAA
TGCGCCGATATCCCGGTCG -> GCGCCGATATCCCGGTCGT
TGTAGAATTCAACCCCCGC -> GTAGAATTCAACCCCCGCG
CGATCCGCCAATTGCAAGA -> GATCCGCCAATTGCAAGAC
GACGGAGACGAACTGTCCA -> ACGGAGACGAACTGTCCAA
CTTGCTCATCATGCTATGG -> TTGCTCATCATGCTATGGA
CCCGGTCGTGTCTAGTTTC -> CCGGTCGTGTCTAGTTTCG
CTGTCCAAGCATACGGACA -> TGTCCAAGCATACGGACAT
ATCCTATACGCGTAGCTCT -> TCCTATACGCGTAGCTCTC
GGTACCTTTAGTCAGTTAG -> GTACCTTTAGTCAGTTAGT
GTTAGCACATTCCGTCCAA -> TTAGCACATTCCGTCCAAG
GGCATTACATATTTTAATC -> GCATTACATATTTTAATCC
TACCTGGTGAGGTCTTACT -> ACCTGGTGAGGTCTTACTA
ATATTGGGGAGACTCCCTG -> TATTGGGGAGACTCCCTGC
AGTGGACTTTGTTGTTGTA -> GTGGACTTTGTTGTTGTAT
GTCTGCAACCGCGCTATGC -> TCTGCAACCGCGCTATGCT
AGCGTAGCCCCTAATAATA -> GCGTAGCCCCTAATAATAA
ATGCTCGCTAATGCAGACG -> TGCTCGCTAATGCAGACGC
ATTAGCGATGGTACCTTTA -> TTAGCGATGGTACCTTTAG
ACATAGACACAATTACCTC -> CATAGACACAATTACCTCT
CGGACATTGGTGTCTTGTA -> GGACATTGGTGTCTTGTAG
ACTCATGTCCTGCCAACGG -> CTCATGTCCTGCCAACGGA
GGTATTACTCCGGCGCAAA -> GTATTACTCCGGCGCAAAA
CACGATCCGCCAATTGCAA -> ACGATCCGCCAATTGCAAG
CAAATGGTCCAGGCCATTT -> AAATGGTCCAGGCCATTTC
GATGCAGTCGCAAATCCTT -> ATGCAGTCGCAAATCCTTT
GAGGCCCTCCGGCTTTAGC -> AGGCCCTCCGGCTTTAGCC
AGTTATTGCCGTGGGCATC -> GTTATTGCCGTGGGCATCG
AAAAACTACCCTATTGGGG -> AAAACTACCCTATTGGGGA
GTCCTATTGTATGCTAGAA -> TCCTATTGTATGCTAGAAG
TCAGGACGGCATGGTATTA -> CAGGACGGCATGGTATTAC
GCAAACAACTGAACAGTAA -> CAAACAACTGAACAGTAAA
GGCGAATCGTAGCGACGGG -> GCGAATCGTAGCGACGGGT
TTGATCCCGGTCGTGTCTA -> TGATCCCGGTCGTGTCTAG
AAGACACACTTACTCATGT -> AGACACACTTACTCATGTC
ATATTTTAATCCCGGTCGT -> TATTTTAATCCCGGTCGTG
TCCAATCCCTGTAGCAATG -> CCAATCCCTGTAGCAATGA
GATAAAGCGTACCTGGTGA -> ATAAAGCGTACCTGGTGAG
AAGTGGACTTTGTTGTTGT -> AGTGGACTTTGTTGTTGTA
ATTTATTCCCGACATTTCG -> TTTATTCCCGACATTTCGT
TGATATAACGTTACTCCCG -> GATATAACGTTACTCCCGC
TCGTCCACAAGGAGCCGGC -> CGTCCACAAGGAGCCGGCT
CCACGTCGAGCCTCCGCTT -> CACGTCGAGCCTCCGCTTA
TAGTTGACCCTTTTCCGGC -> AGTTGACCCTTTTCCGGCT
GCACTTAGACCAGGCAATG -> CACTTAGACCAGGCAATGG
CTACCTGGGCCACTCAGGC -> TACCTGGGCCACTCAGGCC
ATTGGGTAACTTGAGATAT -> TTGGGTAACTTGAGATATC
CCGATATCCCGGTCGTGTC -> CGATATCCCGGTCGTGTCT
CTAATAATAAATCTTATAC -> TAATAATAAATCTTATACC
ATCCGCCAATTGCAAGACA -> TCCGCCAATTGCAAGACAC
CGGGACGATCCTGAAATTA -> GGGACGATCCTGAAATTAA
TCCGGCGCAAAATGCTCGC -> CCGGCGCAAAATGCTCGCT
GATGAAGCAAGTACCATAG -> ATGAAGCAAGTACCATAGT
ATCCCGGTCGTGTCTAGTA -> TCCCGGTCGTGTCTAGTAA
TCTTTAGTTCCCGATGAAG -> CTTTAGTTCCCGATGAAGC
CAACTAGAAGAGGCCCTCC -> AACTAGAAGAGGCCCTCCG
CGGAATTCTCCTGATGTGT -> GGAATTCTCCTGATGTGTA
TTTCATTGATCCCGGTCGT -> TTCATTGATCCCGGTCGTG
GGAGCTACCCGGATACTGT -> GAGCTACCCGGATACTGTA
GTCGACACTGGATTCTCGG -> TCGACACTGGATTCTCGGG
GGCTGCGCCCACCGCATCC -> GCTGCGCCCACCGCATCCC
CTATTAAAATTTATTCCCG -> TATTAAAATTTATTCCCGA
AGCGATGGTACCTTTAGTC -> GCGATGGTACCTTTAGTCA
GAAATCCGTAGGAGCTACC -> AAATCCGTAGGAGCTACCC
ATTTCGTAGACTAAATTCG -> TTTCGTAGACTAAATTCGA
ACTATTAAAATTTATTCCC -> CTATTAAAATTTATTCCCG
TCGCTTTTACAAAATTAGC -> CGCTTTTACAAAATTAGCG
TGTTAGCACATTCCGTCCA -> GTTAGCACATTCCGTCCAA
CCGGCGCAAAATGCTCGCT -> CGGCGCAAAATGCTCGCTA
TTAAAATTTATTCCCGACA -> TAAAATTTATTCCCGACAT
GAGCATTGAATACTGCTTA -> AGCATTGAATACTGCTTAT
AGGGTCATCCTAACTATCC -> GGGTCATCCTAACTATCCT
GATATCTAATCGCTGCATC -> ATATCTAATCGCTGCATCG
CTGGTTGTACAGCAAACAA -> TGGTTGTACAGCAAACAAC
ACATATGTTTCGTCGAAGA -> CATATGTTTCGTCGAAGAG
GCCATTTCTTTAGTTCCCG -> CCATTTCTTTAGTTCCCGA
TTTTCCGGCTTGTCGGGAT -> TTTCCGGCTTGTCGGGATC
TGTGAAACTATACAAAGAC -> GTGAAACTATACAAAGACG
GAGACTCCCTGCATGAAGG -> AGACTCCCTGCATGAAGGT
TAGTCAGTTAGTAGTATTT -> AGTCAGTTAGTAGTATTTT
TAGACACAATTACCTCTAC -> AGACACAATTACCTCTACG
TTGTTGAAGTCGCAAACGG -> TGTTGAAGTCGCAAACGGC
GCTTTTTAGCTAGAAGAGG -> CTTTTTAGCTAGAAGAGGC
CCGACATTTCGTAGACTAA -> CGACATTTCGTAGACTAAA
GCATACGGACATTGGTGTC -> CATACGGACATTGGTGTCT
CCACAGTGGAATGTTCAAG -> CACAGTGGAATGTTCAAGG
ATTCTCCTGATGTGTAAAT -> TTCTCCTGATGTGTAAATC
TCAGCTCGACACGGCCCTG -> CAGCTCGACACGGCCCTGA
TGCCAACGGAATCGCGGAA -> GCCAACGGAATCGCGGAAT
CTACGGTTCGTCCACAAGG -> TACGGTTCGTCCACAAGGA
AGCCTCCGCTTATGCGAAA -> GCCTCCGCTTATGCGAAAG
ACATGTTTGACCATCTAAG -> CATGTTTGACCATCTAAGC
CCCCTAATAATAAATCTTA -> CCCTAATAATAAATCTTAT
GCATCCCGGTCGTGTCTAG -> CATCCCGGTCGTGTCTAGT
GGAGTATGCGGCGGCGAAT -> GAGTATGCGGCGGCGAATC
AGACTAAATTCGACTCTTC -> GACTAAATTCGACTCTTCG
TCGCAAACGGCTGCGGGAC -> CGCAAACGGCTGCGGGACG
TCGGCACCAACTAGAAGAG -> CGGCACCAACTAGAAGAGG
TTTCCGCCAGCCGCCGGGT -> TTCCGCCAGCCGCCGGGTC
GGGTCATCCTAACTATCCT -> GGTCATCCTAACTATCCTA
CCATAGTACAGAACTGCAG -> CATAGTACAGAACTGCAGG
AAGTCGCAAACGGCTGCGG -> AGTCGCAAACGGCTGCGGG
GAAACTATACAAAGACGCA -> AAACTATACAAAGACGCAC
GTAGTTGACCCTTTTCCGG -> TAGTTGACCCTTTTCCGGC
GCGAATACCTTCATTTCTG -> CGAATACCTTCATTTCTGA
CGGATACTGTAAGGACGCT -> GGATACTGTAAGGACGCTC
CCTTGGATGTTTGCCGTTA -> CTTGGATGTTTGCCGTTAA
TATTGCCGTGGGCATCGAT -> ATTGCCGTGGGCATCGATT
TGGTATTACTCCGGCGCAA -> GGTATTACTCCGGCGCAAA
AGTACTAGCCCACAGTGGA -> GTACTAGCCCACAGTGGAA
TTACATAGGCTCTCCCTTG -> TACATAGGCTCTCCCTTGC
AGCTCGAGAGCTGGCTGCG -> GCTCGAGAGCTGGCTGCGC
TTGAAGTCGCAAACGGCTG -> TGAAGTCGCAAACGGCTGC
TAGTTTCAGATAGCACCCG -> AGTTTCAGATAGCACCCGC
CTCGGGTTTTCCACACAAA -> TCGGGTTTTCCACACAAAA
GCAAATCCTTTCGGGGGCA -> CAAATCCTTTCGGGGGCAT
GGCCCTGAACTCTAAAAAA -> GCCCTGAACTCTAAAAAAC
GAGCCGGCTTGCGAATACC -> AGCCGGCTTGCGAATACCT
GCGCCCACCGCATCCCGGT -> CGCCCACCGCATCCCGGTC
CCTGAAATTAAGAAATCCG -> CTGAAATTAAGAAATCCGT
AATTCAACCCCCGCGTGTG -> ATTCAACCCCCGCGTGTGG
CATTGGTGTCTTGTAGGGC -> ATTGGTGTCTTGTAGGGCA
TTCCCGATGAAGCAAGTAC -> TCCCGATGAAGCAAGTACC
CCGAGTTTACATAGGCTCT -> CGAGTTTACATAGGCTCTC
ACATTGGTGTCTTGTAGGG -> CATTGGTGTCTTGTAGGGC
GTGGGGCCAGGACATGGGC -> TGGGGCCAGGACATGGGCA
TAAACGTCCCGTCGGTCAC -> AAACGTCCCGTCGGTCACT
GTCAGTTAGTAGTATTTTA -> TCAGTTAGTAGTATTTTAT
AAGCTTTTTAGCTAGAAGA -> AGCTTTTTAGCTAGAAGAG
CGACTCTTCGCTTTTACAA -> GACTCTTCGCTTTTACAAA
TCCAGTTATTGCCGTGGGC -> CCAGTTATTGCCGTGGGCA
AGGGGCACGTGTCGACACT -> GGGGCACGTGTCGACACTG
GTTGTATACAAAAGGACTC -> TTGTATACAAAAGGACTCA
CTGGCTGCGCCCACCGCAT -> TGGCTGCGCCCACCGCATC
GAGGCCCTCCGGCCCACCC -> AGGCCCTCCGGCCCACCCA
TGAGATATCTAATCGCTGC -> GAGATATCTAATCGCTGCA
GGCCCTCCGGCTTTAGCCG -> GCCCTCCGGCTTTAGCCGT
TAACGTTACTCCCGCAAGC -> AACGTTACTCCCGCAAGCA
AGAGCCTGCCCACTGCGCC -> GAGCCTGCCCACTGCGCCG
TGTTGTTTCCGCCAGCCGC -> GTTGTTTCCGCCAGCCGCC
ACCCTATTGGGGACTTCCT -> CCCTATTGGGGACTTCCTA
GAAGCAAGTACCATAGTAC -> AAGCAAGTACCATAGTACA
CTTTTCCGGCTTGTCGGGA -> TTTTCCGGCTTGTCGGGAT
GCTGGCTGCGCCCACCGCA -> CTGGCTGCGCCCACCGCAT
TTATTGCCGTGGGCATCGA -> TATTGCCGTGGGCATCGAT
GCGATTGGTTGCTGGTTGT -> CGATTGGTTGCTGGTTGTA
TATGGAGATGGAGCGTAGC -> ATGGAGATGGAGCGTAGCC
CGCCAGCCGCCGGGTCTGT -> GCCAGCCGCCGGGTCTGTG
ATTAGTGGCGCTATTAACA -> TTAGTGGCGCTATTAACAT
CTGTGATCCAAAACTAATC -> TGTGATCCAAAACTAATCC
TACTCATGTCCTGCCAACG -> ACTCATGTCCTGCCAACGG
CCCTATTGGGGACTTCCTA -> CCTATTGGGGACTTCCTAA
TAACCAACGGCTGTGATCC -> AACCAACGGCTGTGATCCA
GTGAGGCACTTCCAATCCC -> TGAGGCACTTCCAATCCCT
CTCGATATGTCATACTTGG -> TCGATATGTCATACTTGGG
GGCTGTGATCCAAAACTAA -> GCTGTGATCCAAAACTAAT
CTAAATTCGACTCTTCGCT -> TAAATTCGACTCTTCGCTT
GAGCCTGCCCACTGCGCCG -> AGCCTGCCCACTGCGCCGA
CGACTAGTTTCAGATAGCA -> GACTAGTTTCAGATAGCAC
CCGTTAAGCTCGAGAGCTG -> CGTTAAGCTCGAGAGCTGG
CGGCTGCGGGACGATCCTG -> GGCTGCGGGACGATCCTGA
ATAGTACAGAACTGCAGGG -> TAGTACAGAACTGCAGGGG
CCCGGTCGTGTCTAGTAAG -> CCGGTCGTGTCTAGTAAGC
GCAACCGCGCTATGCTACC -> CAACCGCGCTATGCTACCC
AGCCCACAGTGGAATGTTC -> GCCCACAGTGGAATGTTCA
CACATTCCGTCCAAGAGAG -> ACATTCCGTCCAAGAGAGG
CTATGGAGGACGGAGACGA -> TATGGAGGACGGAGACGAA
GCGAATGTTAGCACATTCC -> CGAATGTTAGCACATTCCG
TTTACATGTTTGACCATCT -> TTACATGTTTGACCATCTA
GTGTCGACCAAATCGCACA -> TGTCGACCAAATCGCACAT
AACTCTAAAAAACTACCCT -> ACTCTAAAAAACTACCCTA
TGCACGTTTACATGTTTGA -> GCACGTTTACATGTTTGAC
TATACCACGTCGAGCCTCC -> ATACCACGTCGAGCCTCCG
AATCGCGAAGAGCCTGCCC -> ATCGCGAAGAGCCTGCCCA
CATATGTTTCGTCGAAGAG -> ATATGTTTCGTCGAAGAGC
CTCCGCTTATGCGAAAGCA -> TCCGCTTATGCGAAAGCAG
AGTTTCAGATAGCACCCGC -> GTTTCAGATAGCACCCGCA
GGGATTCCTCATCAGCAAT -> GGATTCCTCATCAGCAATG
ACCCAGTTCGGAGCCGGTT -> CCCAGTTCGGAGCCGGTTT
CGCAAGCATCAGGATGCAG -> GCAAGCATCAGGATGCAGT
TCGGGTTTTCCACACAAAA -> CGGGTTTTCCACACAAAAG
AATGATTGGGTAACTTGAG -> ATGATTGGGTAACTTGAGA
AGGCCCTCCGGCTTTAGCC -> GGCCCTCCGGCTTTAGCCG
TGCGCCCACCGCATCCCGG -> GCGCCCACCGCATCCCGGT
AAATTAGTTTGTAGAGGTG -> AATTAGTTTGTAGAGGTGT
ACCCAAGTGGCTTGCTCAT -> CCCAAGTGGCTTGCTCATC
AAACTAATCCAGTTATTGC -> AACTAATCCAGTTATTGCC
TATGCGGCGGCGAATCGTA -> ATGCGGCGGCGAATCGTAG
ACTGTGAGGATAAAGCGTA -> CTGTGAGGATAAAGCGTAC
GCCCTCCGGCCCACCCAGT -> CCCTCCGGCCCACCCAGTT
CATGTTTGACCATCTAAGC -> ATGTTTGACCATCTAAGCT
TCCTGCCAACGGAATCGCG -> CCTGCCAACGGAATCGCGG
TTACTCATGTCCTGCCAAC -> TACTCATGTCCTGCCAACG
ATTGGTGTCTTGTAGGGCA -> TTGGTGTCTTGTAGGGCAT
TGGGTAACTTGAGATATCT -> GGGTAACTTGAGATATCTA
TAATATTGGGGAGACTCCC -> AATATTGGGGAGACTCCCT
ACGGAATCGCGGAATTCTC -> CGGAATCGCGGAATTCTCC
TGACCTACCTGGGCCACTC -> GACCTACCTGGGCCACTCA
GTATTTTATGCGTTTATTT -> TATTTTATGCGTTTATTTA
AAACTATACAAAGACGCAC -> AACTATACAAAGACGCACT
AGGCGTCTTATTTTCATTG -> GGCGTCTTATTTTCATTGA
GGTTGCTGGTTGTACAGCA -> GTTGCTGGTTGTACAGCAA
CATCATGCTATGGAGGACG -> ATCATGCTATGGAGGACGG
CAATTGTCTATTTCGTGTA -> AATTGTCTATTTCGTGTAG
GCTTGTCGGGATCAAGCCT -> CTTGTCGGGATCAAGCCTA
CACTTAGACCAGGCAATGG -> ACTTAGACCAGGCAATGGG
TTCGTCGAAGAGCGTGAGG -> TCGTCGAAGAGCGTGAGGC
GGGACGATCCTGAAATTAA -> GGACGATCCTGAAATTAAG
GTAGTGTCGACCAAATCGC -> TAGTGTCGACCAAATCGCA
ATGTGTAAATCCCAACCCT -> TGTGTAAATCCCAACCCTG
AACTAATCCAGTTATTGCC -> ACTAATCCAGTTATTGCCG
GCCGGTTTATGGAGATGGA -> CCGGTTTATGGAGATGGAG
GCGATGGTACCTTTAGTCA -> CGATGGTACCTTTAGTCAG
CCATCTAAGCTGCAAGTCA -> CATCTAAGCTGCAAGTCAC
TCAGGCCTTAGCTGTTATA -> CAGGCCTTAGCTGTTATAC
GACGCTCAGCTCGACACGG -> ACGCTCAGCTCGACACGGC
CGTTGACCTACCTGGGCCA -> GTTGACCTACCTGGGCCAC
GCGTGAGGCACTTCCAATC -> CGTGAGGCACTTCCAATCC
ACTGTAAGGACGCTCAGCT -> CTGTAAGGACGCTCAGCTC
TTATTCCCGACATTTCGTA -> TATTCCCGACATTTCGTAG
TTATTTTCATTGATCCCGG -> TATTTTCATTGATCCCGGT
GCCCTCCGGCGGAGGGGCA -> CCCTCCGGCGGAGGGGCAG
CAAGCCTATAAACGTCCCG -> AAGCCTATAAACGTCCCGT
CACACTTACTCATGTCCTG -> ACACTTACTCATGTCCTGC
AGAGGCCCTCCGGCCCACC -> GAGGCCCTCCGGCCCACCC
AACATAGACACAATTACCT -> ACATAGACACAATTACCTC
TCGGGATCAAGCCTATAAA -> CGGGATCAAGCCTATAAAC
CCCTTGCGATTGGTTGCTG -> CCTTGCGATTGGTTGCTGG
GATTTAATATTGGGGAGAC -> ATTTAATATTGGGGAGACT
CTTCGCTTTTACAAAATTA -> TTCGCTTTTACAAAATTAG
ACTAAATTCGACTCTTCGC -> CTAAATTCGACTCTTCGCT
AGTGCACTAATACGCTAGA -> GTGCACTAATACGCTAGAA
ACTTTGTTGTTGTATACAA -> CTTTGTTGTTGTATACAAA
TCCTGAAATTAAGAAATCC -> CCTGAAATTAAGAAATCCG
AATGGTCCAGGCCATTTCT -> ATGGTCCAGGCCATTTCTT
TGGAGATGGAGCGTAGCCC -> GGAGATGGAGCGTAGCCCC
CGGGTTTTCCACACAAAAG -> GGGTTTTCCACACAAAAGC
CAGTGGAATGTTCAAGGTT -> AGTGGAATGTTCAAGGTTT
GCACTCGTTGACCTACCTG -> CACTCGTTGACCTACCTGG
GGGCAGGCGTCTTATTTTC -> GGCAGGCGTCTTATTTTCA
AGGCCCTCCGGCGGAGGGG -> GGCCCTCCGGCGGAGGGGC
ATGCTACCCAAGTGGCTTG -> TGCTACCCAAGTGGCTTGC
CCCGCGTGTGGGGCCAGGA -> CCGCGTGTGGGGCCAGGAC
TCACTCGGGGAGTATGCGG -> CACTCGGGGAGTATGCGGC
CGGCTTGTCGGGATCAAGC -> GGCTTGTCGGGATCAAGCC
ACTTAGACCAGGCAATGGG -> CTTAGACCAGGCAATGGGA
CTCCCTTGCGATTGGTTGC -> TCCCTTGCGATTGGTTGCT
TGAAGGTCTTGATCGCGTG -> GAAGGTCTTGATCGCGTGA
AAGTACCATAGTACAGAAC -> AGTACCATAGTACAGAACT
AGCCGGCTTGCGAATACCT -> GCCGGCTTGCGAATACCTT
ATGTTTCGTCGAAGAGCGT -> TGTTTCGTCGAAGAGCGTG
AGGCAATGGGAACCCAATG -> GGCAATGGGAACCCAATGT
AGCTTTTTAGCTAGAAGAG -> GCTTTTTAGCTAGAAGAGG
TTGACCATCTAAGCTGCAA -> TGACCATCTAAGCTGCAAG
ACTCGTTGACCTACCTGGG -> CTCGTTGACCTACCTGGGC
ATCGATTTCTGCGATGCCG -> TCGATTTCTGCGATGCCGG
ACTTACTCATGTCCTGCCA -> CTTACTCATGTCCTGCCAA
TGAAATAAATCGCGAAGAG -> GAAATAAATCGCGAAGAGC
TACCATTGCTTAAGTTATT -> ACCATTGCTTAAGTTATTC
TTGTTGTATACAAAAGGAC -> TGTTGTATACAAAAGGACT
CAAGTGGACTTTGTTGTTG -> AAGTGGACTTTGTTGTTGT
TTAGTGGCGCTATTAACAT -> TAGTGGCGCTATTAACATA
GAGGCCCTCCGGCGGAGGG -> AGGCCCTCCGGCGGAGGGG
CATGTCCTGCCAACGGAAT -> ATGTCCTGCCAACGGAATC
CGGAGACGAACTGTCCAAG -> GGAGACGAACTGTCCAAGC
TGCTTATCTTGCACGATCC -> GCTTATCTTGCACGATCCG
CGTGTCTAGTGCACTAATA -> GTGTCTAGTGCACTAATAC
CAGAGCATTGAATACTGCT -> AGAGCATTGAATACTGCTT
CTTATGCGAAAGCAGTACT -> TTATGCGAAAGCAGTACTA
TGTGGCGAATGTTAGCACA -> GTGGCGAATGTTAGCACAT
TTCAACCCCCGCGTGTGGG -> TCAACCCCCGCGTGTGGGG
GCTATGGAGGACGGAGACG -> CTATGGAGGACGGAGACGA
TTGCTTAAGTTATTCGGCG -> TGCTTAAGTTATTCGGCGA
TGGTTGCTGGTTGTACAGC -> GGTTGCTGGTTGTACAGCA
TATAACGTTACTCCCGCAA -> ATAACGTTACTCCCGCAAG
GACGGGTGATATAACGTTA -> ACGGGTGATATAACGTTAC
GGCCACTCAGGCCTTAGCT -> GCCACTCAGGCCTTAGCTG
CAGCTCGACACGGCCCTGA -> AGCTCGACACGGCCCTGAA
ACTGAACAGTAAACGAACT -> CTGAACAGTAAACGAACTG
TGCGGCGGCGAATCGTAGC -> GCGGCGGCGAATCGTAGCG
GACACAATTACCTCTACGG -> ACACAATTACCTCTACGGT
TCATTTCTGAGTAGTTGAC -> CATTTCTGAGTAGTTGACC
GAGAAGGCCAGATCCGAGT -> AGAAGGCCAGATCCGAGTT
AGTTCGGAGCCGGTTTATG -> GTTCGGAGCCGGTTTATGG
CAAGCATCAGGATGCAGTC -> AAGCATCAGGATGCAGTCG
TTCTGAGTAGTTGACCCTT -> TCTGAGTAGTTGACCCTTT
TAGACTAAATTCGACTCTT -> AGACTAAATTCGACTCTTC
AGGACTCAGGACGGCATGG -> GGACTCAGGACGGCATGGT
CCACTCGATATGTCATACT -> CACTCGATATGTCATACTT
GGGGGCATCGGGGCACTCG -> GGGGCATCGGGGCACTCGT
GCATCGGGGCACTCGTTGA -> CATCGGGGCACTCGTTGAC
CGGCACCAACTAGAAGAGG -> GGCACCAACTAGAAGAGGC
GAAAGCAGTACTAGCCCAC -> AAAGCAGTACTAGCCCACA
CCGTCAGGGTCATCCTAAC -> CGTCAGGGTCATCCTAACT
TTTAGCTAGAAGAGGCCCT -> TTAGCTAGAAGAGGCCCTC
CGCCGATATCCCGGTCGTG -> GCCGATATCCCGGTCGTGT
CGATTTCTGCGATGCCGGT -> GATTTCTGCGATGCCGGTT
GATGTTTGCCGTTAAGCTC -> ATGTTTGCCGTTAAGCTCG
GCTTTAGCCGTCAGGGTCA -> CTTTAGCCGTCAGGGTCAT
CTTTTTAGCTAGAAGAGGC -> TTTTTAGCTAGAAGAGGCC
CCCTCCGGCGGAGGGGCAG -> CCTCCGGCGGAGGGGCAGG
GATTCTCGGGTTTTCCACA -> ATTCTCGGGTTTTCCACAC
TGGCATTACATATTTTAAT -> GGCATTACATATTTTAATC
TGGAATGTTCAAGGTTTGT -> GGAATGTTCAAGGTTTGTT
ATTGTTGTTTCCGCCAGCC -> TTGTTGTTTCCGCCAGCCG
AGCAGTACTAGCCCACAGT -> GCAGTACTAGCCCACAGTG
GTCTTGTAGGGCATGGGCG -> TCTTGTAGGGCATGGGCGG
AAAGCGACTAGTTTCAGAT -> AAGCGACTAGTTTCAGATA
GGGCAGGGTGCGTTACGTG -> GGCAGGGTGCGTTACGTGA
GTGGAATGTTCAAGGTTTG -> TGGAATGTTCAAGGTTTGT
TCCGGCTTTAGCCGTCAGG -> CCGGCTTTAGCCGTCAGGG
GCCAATTGCAAGACACACT -> CCAATTGCAAGACACACTT
TGGCTGCGCCCACCGCATC -> GGCTGCGCCCACCGCATCC
CGTCTGCAACCGCGCTATG -> GTCTGCAACCGCGCTATGC
AGAAGGCCAGATCCGAGTT -> GAAGGCCAGATCCGAGTTT
ACCCCCGCGTGTGGGGCCA -> CCCCCGCGTGTGGGGCCAG
AGTACAGAACTGCAGGGGC -> GTACAGAACTGCAGGGGCA
CGCCTCACAGAATTATGTG -> GCCTCACAGAATTATGTGG
CATGGGCGGAAAGCTTACT -> ATGGGCGGAAAGCTTACTG
GTGCCTCTTCACGCATTAG -> TGCCTCTTCACGCATTAGT
GGCGAATGTTAGCACATTC -> GCGAATGTTAGCACATTCC
GCACTACCATTGCTTAAGT -> CACTACCATTGCTTAAGTT
TAGAAGAGGCCCTCCGGCA -> AGAAGAGGCCCTCCGGCAA
GCCGTGGGCATCGATTTCT -> CCGTGGGCATCGATTTCTG
TCCCGTCGGTCACTCGGGG -> CCCGTCGGTCACTCGGGGA
ATTGATCCCGGTCGTGTCT -> TTGATCCCGGTCGTGTCTA
GCTTATCTTGCACGATCCG -> CTTATCTTGCACGATCCGC
GTAGCCCCTAATAATAAAT -> TAGCCCCTAATAATAAATC
GGGACTCAAATGGTCCAGG -> GGACTCAAATGGTCCAGGC
GGCTTGCGAATACCTTCAT -> GCTTGCGAATACCTTCATT
GCTGCAAGTCACGTGGGAT -> CTGCAAGTCACGTGGGATT
TATTACTCCGGCGCAAAAT -> ATTACTCCGGCGCAAAATG
AAGAGGCCCTCCGGCAAGT -> AGAGGCCCTCCGGCAAGTG
TAGCACATTCCGTCCAAGA -> AGCACATTCCGTCCAAGAG
CAGAATTATGTGGCGAATG -> AGAATTATGTGGCGAATGT
TACTATTAAAATTTATTCC -> ACTATTAAAATTTATTCCC
GCATTAGTGGCGCTATTAA -> CATTAGTGGCGCTATTAAC
TAGTGTCGACCAAATCGCA -> AGTGTCGACCAAATCGCAC
TCGGTCACTCGGGGAGTAT -> CGGTCACTCGGGGAGTATG
CTCTACGGTTCGTCCACAA -> TCTACGGTTCGTCCACAAG
CCACCGCATCCCGGTCGTG -> CACCGCATCCCGGTCGTGT
TCCGCCAATTGCAAGACAC -> CCGCCAATTGCAAGACACA
TAACTATCCTATACGCGTA -> AACTATCCTATACGCGTAG
ACGTTTACATGTTTGACCA -> CGTTTACATGTTTGACCAT
TGTTTCGTCGAAGAGCGTG -> GTTTCGTCGAAGAGCGTGA
ATCGGGGCACTCGTTGACC -> TCGGGGCACTCGTTGACCT
CTACCCGGATACTGTAAGG -> TACCCGGATACTGTAAGGA
TGCTATGGAGGACGGAGAC -> GCTATGGAGGACGGAGACG
TCCCGGTCGTGTCTAGTTT -> CCCGGTCGTGTCTAGTTTC
TTCATTTCTGAGTAGTTGA -> TCATTTCTGAGTAGTTGAC
AGAGGTGTGCGCCTCACAG -> GAGGTGTGCGCCTCACAGA
TACATAGGCTCTCCCTTGC -> ACATAGGCTCTCCCTTGCG
CTATCCTATACGCGTAGCT -> TATCCTATACGCGTAGCTC
CGATTGGCATTACATATTT -> GATTGGCATTACATATTTT
TATCCTATACGCGTAGCTC -> ATCCTATACGCGTAGCTCT
TCGACACGGCCCTGAACTC -> CGACACGGCCCTGAACTCT
TTTGACCATCTAAGCTGCA -> TTGACCATCTAAGCTGCAA
GAGGTCTTACTATTAAAAT -> AGGTCTTACTATTAAAATT
ATTGGCATTACATATTTTA -> TTGGCATTACATATTTTAA
TTTAGCCGTCAGGGTCATC -> TTAGCCGTCAGGGTCATCC
CGTCAGGGTCATCCTAACT -> GTCAGGGTCATCCTAACTA
CGGTCGTGTCTAGTGCACT -> GGTCGTGTCTAGTGCACTA
AAATCTTATACCACGTCGA -> AATCTTATACCACGTCGAG
TACTAGCCCACAGTGGAAT -> ACTAGCCCACAGTGGAATG
GATTGGTTGCTGGTTGTAC -> ATTGGTTGCTGGTTGTACA
GCGACGGGTGATATAACGT -> CGACGGGTGATATAACGTT
GTCCAAGAGAGGGACTCAA -> TCCAAGAGAGGGACTCAAA
GGAATCGCGGAATTCTCCT -> GAATCGCGGAATTCTCCTG
AGCTCGACACGGCCCTGAA -> GCTCGACACGGCCCTGAAC
CAGTCGCAAATCCTTTCGG -> AGTCGCAAATCCTTTCGGG
ATCCAAAACTAATCCAGTT -> TCCAAAACTAATCCAGTTA
TGGTACCTTTAGTCAGTTA -> GGTACCTTTAGTCAGTTAG
GGTTCGTCCACAAGGAGCC -> GTTCGTCCACAAGGAGCCG
CCTCACAGAATTATGTGGC -> CTCACAGAATTATGTGGCG
GGGCGGAAAGCTTACTGAA -> GGCGGAAAGCTTACTGAAA
TAGAGCAATTGCCACTCGA -> AGAGCAATTGCCACTCGAT
TGTGGGGCCAGGACATGGG -> GTGGGGCCAGGACATGGGC
CCTGCCAACGGAATCGCGG -> CTGCCAACGGAATCGCGGA
GACGAACTGTCCAAGCATA -> ACGAACTGTCCAAGCATAC
CAGATCCGAGTTTACATAG -> AGATCCGAGTTTACATAGG
TCCTCATCAGCAATGAGGT -> CCTCATCAGCAATGAGGTA
AGGACGGCATGGTATTACT -> GGACGGCATGGTATTACTC
CTTTAGCCGTCAGGGTCAT -> TTTAGCCGTCAGGGTCATC
CGGCCCACCCAGTTCGGAG -> GGCCCACCCAGTTCGGAGC
GCAGGCGTCTTATTTTCAT -> CAGGCGTCTTATTTTCATT
GTAGACTAAATTCGACTCT -> TAGACTAAATTCGACTCTT
AGCCGCCGGGTCTGTGAAA -> GCCGCCGGGTCTGTGAAAC
CACCGCATCCCGGTCGTGT -> ACCGCATCCCGGTCGTGTC
GCCTTAGCTGTTATACGCT -> CCTTAGCTGTTATACGCTG
CATAGACACAATTACCTCT -> ATAGACACAATTACCTCTA
AGTCAGTTAGTAGTATTTT -> GTCAGTTAGTAGTATTTTA
GAATCGCGGAATTCTCCTG -> AATCGCGGAATTCTCCTGA
ACCAACTAGAAGAGGCCCT -> CCAACTAGAAGAGGCCCTC
GTCGAGCCTCCGCTTATGC -> TCGAGCCTCCGCTTATGCG
GGATCAAGCCTATAAACGT -> GATCAAGCCTATAAACGTC
GGGTGATATAACGTTACTC -> GGTGATATAACGTTACTCC
TGCCACTCGATATGTCATA -> GCCACTCGATATGTCATAC
GGACTCAAATGGTCCAGGC -> GACTCAAATGGTCCAGGCC
GCCCTCCGGCTTTAGCCGT -> CCCTCCGGCTTTAGCCGTC
TCGAGAGCTGGCTGCGCCC -> CGAGAGCTGGCTGCGCCCA
AGCCGGTTTATGGAGATGG -> GCCGGTTTATGGAGATGGA
TTACGTGATTTAATATTGG -> TACGTGATTTAATATTGGG
TTCCGCCAGCCGCCGGGTC -> TCCGCCAGCCGCCGGGTCT
GGTGAGGTCTTACTATTAA -> GTGAGGTCTTACTATTAAA
AAGAGGCCCTCCGGCCCAC -> AGAGGCCCTCCGGCCCACC
AGGTCTTGATCGCGTGATG -> GGTCTTGATCGCGTGATGA
TTGCGATTGGTTGCTGGTT -> TGCGATTGGTTGCTGGTTG
TATACGCTGCACGTTTACA -> ATACGCTGCACGTTTACAT
GCCTCTTCACGCATTAGTG -> CCTCTTCACGCATTAGTGG
CGTCCAAGAGAGGGACTCA -> GTCCAAGAGAGGGACTCAA
AACTAGAAGAGGCCCTCCG -> ACTAGAAGAGGCCCTCCGG
AATTTATTCCCGACATTTC -> ATTTATTCCCGACATTTCG
CCGTCGGTCACTCGGGGAG -> CGTCGGTCACTCGGGGAGT
ATACAAAGACGCACTTAGA -> TACAAAGACGCACTTAGAC
TAAAGCGTACCTGGTGAGG -> AAAGCGTACCTGGTGAGGT
CTGAAATAAATCGCGAAGA -> TGAAATAAATCGCGAAGAG
TATCTTGCACGATCCGCCA -> ATCTTGCACGATCCGCCAA
AGCACCCGCACTACCATTG -> GCACCCGCACTACCATTGC
TATTGTATGCTAGAAGAGG -> ATTGTATGCTAGAAGAGGC
CAAGCATACGGACATTGGT -> AAGCATACGGACATTGGTG
AAGAGAGGGACTCAAATGG -> AGAGAGGGACTCAAATGGT
GCGTCTGCAACCGCGCTAT -> CGTCTGCAACCGCGCTATG
GAGCAATTGCCACTCGATA -> AGCAATTGCCACTCGATAT
TTAACCAACGGCTGTGATC -> TAACCAACGGCTGTGATCC
TACTGTAAGGACGCTCAGC -> ACTGTAAGGACGCTCAGCT
AAATGCTCGCTAATGCAGA -> AATGCTCGCTAATGCAGAC
ATACGCGTAGCTCTCGTGC -> TACGCGTAGCTCTCGTGCC
GAAGAGGCCCTCCGGCGGA -> AAGAGGCCCTCCGGCGGAG
CACAGTGGAATGTTCAAGG -> ACAGTGGAATGTTCAAGGT
TCCGGCCCACCCAGTTCGG -> CCGGCCCACCCAGTTCGGA
TGCAGGGGCACGTGTCGAC -> GCAGGGGCACGTGTCGACA
TCCGCCAGCCGCCGGGTCT -> CCGCCAGCCGCCGGGTCTG
CTGCCAACGGAATCGCGGA -> TGCCAACGGAATCGCGGAA
GTTACGTGATTTAATATTG -> TTACGTGATTTAATATTGG
CATGAAGGTCTTGATCGCG -> ATGAAGGTCTTGATCGCGT
CACAATTGTCTATTTCGTG -> ACAATTGTCTATTTCGTGT
CTCATGTCCTGCCAACGGA -> TCATGTCCTGCCAACGGAA
ACCGCGCTATGCTACCCAA -> CCGCGCTATGCTACCCAAG
ATCCCGGTCGTGTCTAGTG -> TCCCGGTCGTGTCTAGTGC
CTGCACGTTTACATGTTTG -> TGCACGTTTACATGTTTGA
GTACAGCAAACAACTGAAC -> TACAGCAAACAACTGAACA
TTGGGGACTTCCTAAAAGA -> TGGGGACTTCCTAAAAGAG
TTGCTGGTTGTACAGCAAA -> TGCTGGTTGTACAGCAAAC
AGGATGCAGTCGCAAATCC -> GGATGCAGTCGCAAATCCT
GCACGTTTACATGTTTGAC -> CACGTTTACATGTTTGACC
AGCTGGCTGCGCCCACCGC -> GCTGGCTGCGCCCACCGCA
TTGATCGCGTGATGAGAAG -> TGATCGCGTGATGAGAAGG
AACCGCGCTATGCTACCCA -> ACCGCGCTATGCTACCCAA
ATGAAGCAAGTACCATAGT -> TGAAGCAAGTACCATAGTA
AATTACCTCTACGGTTCGT -> ATTACCTCTACGGTTCGTC
AGGACATGGGCAGGCGTCT -> GGACATGGGCAGGCGTCTT
AGGGGCAGGGTGCGTTACG -> GGGGCAGGGTGCGTTACGT
GGCAGGGTGCGTTACGTGA -> GCAGGGTGCGTTACGTGAT
CGCCGGGTCTGTGAAACTA -> GCCGGGTCTGTGAAACTAT
GTCCAGGCTTCTCATCTTT -> TCCAGGCTTCTCATCTTTC
GATGAGAAGGCCAGATCCG -> ATGAGAAGGCCAGATCCGA
AGTGGAATGTTCAAGGTTT -> GTGGAATGTTCAAGGTTTG
CTTTTACAAAATTAGCGAT -> TTTTACAAAATTAGCGATG
GAGTACGCAATTGTTGTTT -> AGTACGCAATTGTTGTTTC
TTTCAGATAGCACCCGCAC -> TTCAGATAGCACCCGCACT
GTTGCTGGTTGTACAGCAA -> TTGCTGGTTGTACAGCAAA
GCTGCACGTTTACATGTTT -> CTGCACGTTTACATGTTTG
AAGAGCGTGAGGCACTTCC -> AGAGCGTGAGGCACTTCCA
CCCACTGCGCCGATATCCC -> CCACTGCGCCGATATCCCG
TGATCCCGGTCGTGTCTAG -> GATCCCGGTCGTGTCTAGT
GGAGCGTAGCCCCTAATAA -> GAGCGTAGCCCCTAATAAT
GCAAGTCACGTGGGATTCC -> CAAGTCACGTGGGATTCCT
AGATCCGAGTTTACATAGG -> GATCCGAGTTTACATAGGC
GCTGTGATCCAAAACTAAT -> CTGTGATCCAAAACTAATC
TCTGAGTAGTTGACCCTTT -> CTGAGTAGTTGACCCTTTT
CCTTGCGATTGGTTGCTGG -> CTTGCGATTGGTTGCTGGT
CTCCGGCGGAGGGGCAGGG -> TCCGGCGGAGGGGCAGGGT
GTGATATAACGTTACTCCC -> TGATATAACGTTACTCCCG
GTAGAGGTGTGCGCCTCAC -> TAGAGGTGTGCGCCTCACA
GCTCGAGAGCTGGCTGCGC -> CTCGAGAGCTGGCTGCGCC
AGCAATTGCCACTCGATAT -> GCAATTGCCACTCGATATG
TAGGAGCTACCCGGATACT -> AGGAGCTACCCGGATACTG
CACAAGGAGCCGGCTTGCG -> ACAAGGAGCCGGCTTGCGA
CCGCCGGGTCTGTGAAACT -> CGCCGGGTCTGTGAAACTA
TTACATATTTTAATCCCGG -> TACATATTTTAATCCCGGT
GAATACCTTCATTTCTGAG -> AATACCTTCATTTCTGAGT
GACCCTTTTCCGGCTTGTC -> ACCCTTTTCCGGCTTGTCG
CTCGTTGACCTACCTGGGC -> TCGTTGACCTACCTGGGCC
ACAATTACCTCTACGGTTC -> CAATTACCTCTACGGTTCG
CAGGCCATTTCTTTAGTTC -> AGGCCATTTCTTTAGTTCC
CAAATCCTTTCGGGGGCAT -> AAATCCTTTCGGGGGCATC
CAATGGGAACCCAATGTTA -> AATGGGAACCCAATGTTAA
TGGGGAGACTCCCTGCATG -> GGGGAGACTCCCTGCATGA
GTATACAAAAGGACTCAGG -> TATACAAAAGGACTCAGGA
TACTCCGGCGCAAAATGCT -> ACTCCGGCGCAAAATGCTC
GTGGCGCTATTAACATAGA -> TGGCGCTATTAACATAGAC
CCTCCGGCAAGTGGACTTT -> CTCCGGCAAGTGGACTTTG
AGACCAGGCAATGGGAACC -> GACCAGGCAATGGGAACCC
CCTTTCGGGGGCATCGGGG -> CTTTCGGGGGCATCGGGGC
TATCCCGGTCGTGTCTAGT -> ATCCCGGTCGTGTCTAGTT
TTAACATAGACACAATTAC -> TAACATAGACACAATTACC
TCGGGGAGTATGCGGCGGC -> CGGGGAGTATGCGGCGGCG
CACCCAGTTCGGAGCCGGT -> ACCCAGTTCGGAGCCGGTT
ACTGCTTATCTTGCACGAT -> CTGCTTATCTTGCACGATC
GTAACTTGAGATATCTAAT -> TAACTTGAGATATCTAATC
AGCCCCTAATAATAAATCT -> GCCCCTAATAATAAATCTT
TACGGACATTGGTGTCTTG -> ACGGACATTGGTGTCTTGT
CGCATTAGTGGCGCTATTA -> GCATTAGTGGCGCTATTAA
ATACAAAAGGACTCAGGAC -> TACAAAAGGACTCAGGACG
TGCCCACTGCGCCGATATC -> GCCCACTGCGCCGATATCC
ATGCGTTTATTTAGTGGCA -> TGCGTTTATTTAGTGGCAC
GTGTCTAGTCCTATTGTAT -> TGTCTAGTCCTATTGTATG
CATTGCTTAAGTTATTCGG -> ATTGCTTAAGTTATTCGGC
TTTCTGCGATGCCGGTTGT -> TTCTGCGATGCCGGTTGTA
CGGAAAGCTTACTGAAATT -> GGAAAGCTTACTGAAATTA
CGCCAATTGCAAGACACAC -> GCCAATTGCAAGACACACT
TATACAAAAGGACTCAGGA -> ATACAAAAGGACTCAGGAC
GAACTGTCCAAGCATACGG -> AACTGTCCAAGCATACGGA
GTCTAGTCCTATTGTATGC -> TCTAGTCCTATTGTATGCT
CCAGTTATTGCCGTGGGCA -> CAGTTATTGCCGTGGGCAT
GACTAGTTTCAGATAGCAC -> ACTAGTTTCAGATAGCACC
TGCAAGACACACTTACTCA -> GCAAGACACACTTACTCAT
TGTCATACTTGGGTGTGCC -> GTCATACTTGGGTGTGCCT
CGTCGAGCCTCCGCTTATG -> GTCGAGCCTCCGCTTATGC
CCAGCCGCCGGGTCTGTGA -> CAGCCGCCGGGTCTGTGAA
ACGATCCGCCAATTGCAAG -> CGATCCGCCAATTGCAAGA
CGAAGAGCGTGAGGCACTT -> GAAGAGCGTGAGGCACTTC
TTTCTTTAGTTCCCGATGA -> TTCTTTAGTTCCCGATGAA
CGCGTCTGCAACCGCGCTA -> GCGTCTGCAACCGCGCTAT
TAGGCTCTCCCTTGCGATT -> AGGCTCTCCCTTGCGATTG
GGTTGTACAGCAAACAACT -> GTTGTACAGCAAACAACTG
TTGTAGGGCATGGGCGGAA -> TGTAGGGCATGGGCGGAAA
GTGTCGACACTGGATTCTC -> TGTCGACACTGGATTCTCG
GGGTGTGCCTCTTCACGCA -> GGTGTGCCTCTTCACGCAT
GCTCTCCCTTGCGATTGGT -> CTCTCCCTTGCGATTGGTT
GCGTAGCCCCTAATAATAA -> CGTAGCCCCTAATAATAAA
ATTCGACTCTTCGCTTTTA -> TTCGACTCTTCGCTTTTAC
GCCTCCGCTTATGCGAAAG -> CCTCCGCTTATGCGAAAGC
CCGATGAAGCAAGTACCAT -> CGATGAAGCAAGTACCATA
TAAGCTGCAAGTCACGTGG -> AAGCTGCAAGTCACGTGGG
AATCGCACATATGTTTCGT -> ATCGCACATATGTTTCGTC
GTATTACTCCGGCGCAAAA -> TATTACTCCGGCGCAAAAT
GAGACGAACTGTCCAAGCA -> AGACGAACTGTCCAAGCAT
TGCACTAATACGCTAGAAG -> GCACTAATACGCTAGAAGA
AAGAGTACGCAATTGTTGT -> AGAGTACGCAATTGTTGTT
ATTCAACCCCCGCGTGTGG -> TTCAACCCCCGCGTGTGGG
AGAGCATTGAATACTGCTT -> GAGCATTGAATACTGCTTA
TCTACGGTTCGTCCACAAG -> CTACGGTTCGTCCACAAGG
CGTGTAGAGCAATTGCCAC -> GTGTAGAGCAATTGCCACT
TCCTTTCGGGGGCATCGGG -> CCTTTCGGGGGCATCGGGG
TTCAGATAGCACCCGCACT -> TCAGATAGCACCCGCACTA
TTCGGAGCCGGTTTATGGA -> TCGGAGCCGGTTTATGGAG
GGCGCAAAATGCTCGCTAA -> GCGCAAAATGCTCGCTAAT
CTTGAGATATCTAATCGCT -> TTGAGATATCTAATCGCTG
CTCCCTGCATGAAGGTCTT -> TCCCTGCATGAAGGTCTTG
GTTCGTCCACAAGGAGCCG -> TTCGTCCACAAGGAGCCGG
CCGCGCTATGCTACCCAAG -> CGCGCTATGCTACCCAAGT
ACAAAATTAGCGATGGTAC -> CAAAATTAGCGATGGTACC
TGTAGAGGTGTGCGCCTCA -> GTAGAGGTGTGCGCCTCAC
TGATTTAATATTGGGGAGA -> GATTTAATATTGGGGAGAC
CGACATTTCGTAGACTAAA -> GACATTTCGTAGACTAAAT
TCATGCTATGGAGGACGGA -> CATGCTATGGAGGACGGAG
ATGGAGGACGGAGACGAAC -> TGGAGGACGGAGACGAACT
CCTACCTGGGCCACTCAGG -> CTACCTGGGCCACTCAGGC
CAATGAGGTAGTGTCGACC -> AATGAGGTAGTGTCGACCA
CTGTAAGGACGCTCAGCTC -> TGTAAGGACGCTCAGCTCG
CTTTGTTGTTGTATACAAA -> TTTGTTGTTGTATACAAAA
TATTTTAATCCCGGTCGTG -> ATTTTAATCCCGGTCGTGT
AGCAAGTACCATAGTACAG -> GCAAGTACCATAGTACAGA
GGAGATGGAGCGTAGCCCC -> GAGATGGAGCGTAGCCCCT
TTGGTTGCTGGTTGTACAG -> TGGTTGCTGGTTGTACAGC
TATACGCGTAGCTCTCGTG -> ATACGCGTAGCTCTCGTGC
CTTACTATTAAAATTTATT -> TTACTATTAAAATTTATTC
GACTCAAATGGTCCAGGCC -> ACTCAAATGGTCCAGGCCA
AAGCGACTAGTTTCAGATA -> AGCGACTAGTTTCAGATAG
GGAATTCTCCTGATGTGTA -> GAATTCTCCTGATGTGTAA
TCCGAGTTTACATAGGCTC -> CCGAGTTTACATAGGCTCT
GGAACCCAATGTTAACCAA -> GAACCCAATGTTAACCAAC
TCGCACATATGTTTCGTCG -> CGCACATATGTTTCGTCGA
ATACGCTGCACGTTTACAT -> TACGCTGCACGTTTACATG
GAGCTACCCGGATACTGTA -> AGCTACCCGGATACTGTAA
ACCCGCACTACCATTGCTT -> CCCGCACTACCATTGCTTA
ACTCAAATGGTCCAGGCCA -> CTCAAATGGTCCAGGCCAT
GCGCTATGCTACCCAAGTG -> CGCTATGCTACCCAAGTGG
CCCGCACTACCATTGCTTA -> CCGCACTACCATTGCTTAA
CTGAACAGTAAACGAACTG -> TGAACAGTAAACGAACTGT
TTTCCGGCTTGTCGGGATC -> TTCCGGCTTGTCGGGATCA
CTGTAGCAATGATTGGGTA -> TGTAGCAATGATTGGGTAA
ACGTCCCGTCGGTCACTCG -> CGTCCCGTCGGTCACTCGG
CTTGCACGATCCGCCAATT -> TTGCACGATCCGCCAATTG
GTACGCAATTGTTGTTTCC -> TACGCAATTGTTGTTTCCG
GTCTTGATCGCGTGATGAG -> TCTTGATCGCGTGATGAGA
TACGGTTCGTCCACAAGGA -> ACGGTTCGTCCACAAGGAG
ACCATAGTACAGAACTGCA -> CCATAGTACAGAACTGCAG
CGTGGGATTCCTCATCAGC -> GTGGGATTCCTCATCAGCA
CTCCGGCCCACCCAGTTCG -> TCCGGCCCACCCAGTTCGG
GAACTGTGAGGATAAAGCG -> AACTGTGAGGATAAAGCGT
AGTCGCAAATCCTTTCGGG -> GTCGCAAATCCTTTCGGGG
ACCACGTCGAGCCTCCGCT -> CCACGTCGAGCCTCCGCTT
GTGTGCCTCTTCACGCATT -> TGTGCCTCTTCACGCATTA
TATAAACGTCCCGTCGGTC -> ATAAACGTCCCGTCGGTCA
ACGTGTCGACACTGGATTC -> CGTGTCGACACTGGATTCT
TTAAGTTATTCGGCGATTG -> TAAGTTATTCGGCGATTGG
AGCGACGGGTGATATAACG -> GCGACGGGTGATATAACGT
TGAGGCACTTCCAATCCCT -> GAGGCACTTCCAATCCCTG
TCTGCAACCGCGCTATGCT -> CTGCAACCGCGCTATGCTA
AGGTGTGCGCCTCACAGAA -> GGTGTGCGCCTCACAGAAT
GTGATTTAATATTGGGGAG -> TGATTTAATATTGGGGAGA
GGACTTTGTTGTTGTATAC -> GACTTTGTTGTTGTATACA
CCGGCTTGCGAATACCTTC -> CGGCTTGCGAATACCTTCA
CCGGCCCACCCAGTTCGGA -> CGGCCCACCCAGTTCGGAG
TTCGTGTAGAGCAATTGCC -> TCGTGTAGAGCAATTGCCA
TAAGCTCGAGAGCTGGCTG -> AAGCTCGAGAGCTGGCTGC
GCCAGGACATGGGCAGGCG -> CCAGGACATGGGCAGGCGT
GCAGTACTAGCCCACAGTG -> CAGTACTAGCCCACAGTGG
CCCACCCAGTTCGGAGCCG -> CCACCCAGTTCGGAGCCGG
ATCATGCTATGGAGGACGG -> TCATGCTATGGAGGACGGA
AGCAATGAGGTAGTGTCGA -> GCAATGAGGTAGTGTCGAC
ATTATGTGGCGAATGTTAG -> TTATGTGGCGAATGTTAGC
TAGAAGAGGCCCTCCGGCC -> AGAAGAGGCCCTCCGGCCC
TTAGTTTGTAGAGGTGTGC -> TAGTTTGTAGAGGTGTGCG
TATGCTACCCAAGTGGCTT -> ATGCTACCCAAGTGGCTTG
GCTCGACACGGCCCTGAAC -> CTCGACACGGCCCTGAACT
ACTCGATATGTCATACTTG -> CTCGATATGTCATACTTGG
TGCGATGCCGGTTGTAGAA -> GCGATGCCGGTTGTAGAAT
TTGGGTAACTTGAGATATC -> TGGGTAACTTGAGATATCT
AGTTAGTAGTATTTTATGC -> GTTAGTAGTATTTTATGCG
CGACACTGGATTCTCGGGT -> GACACTGGATTCTCGGGTT
CCGCTTATGCGAAAGCAGT -> CGCTTATGCGAAAGCAGTA
ACCTCTACGGTTCGTCCAC -> CCTCTACGGTTCGTCCACA
GCAGGGGCACGTGTCGACA -> CAGGGGCACGTGTCGACAC
CAGTAAACGAACTGTGAGG -> AGTAAACGAACTGTGAGGA
GTGAAACTATACAAAGACG -> TGAAACTATACAAAGACGC
CTGCAACCGCGCTATGCTA -> TGCAACCGCGCTATGCTAC
AATGCAGACGCGTCTGCAA -> ATGCAGACGCGTCTGCAAC
TGTGATCCAAAACTAATCC -> GTGATCCAAAACTAATCCA
TTGCACGATCCGCCAATTG -> TGCACGATCCGCCAATTGC
TCCCGGTCGTGTCTAGTAA -> CCCGGTCGTGTCTAGTAAG
CTGCGCCGATATCCCGGTC -> TGCGCCGATATCCCGGTCG
TTATACCACGTCGAGCCTC -> TATACCACGTCGAGCCTCC
TATTAACATAGACACAATT -> ATTAACATAGACACAATTA
GCATGGTATTACTCCGGCG -> CATGGTATTACTCCGGCGC
GGCCCTCCGGCCCACCCAG -> GCCCTCCGGCCCACCCAGT
CACTAATACGCTAGAAGAG -> ACTAATACGCTAGAAGAGG
AGAGTACGCAATTGTTGTT -> GAGTACGCAATTGTTGTTT
CTTCCTAAAAGAGTACGCA -> TTCCTAAAAGAGTACGCAA
GGCTTGCTCATCATGCTAT -> GCTTGCTCATCATGCTATG
ATGCTATGGAGGACGGAGA -> TGCTATGGAGGACGGAGAC
ATCCCGGTCGTGTCTAGTC -> TCCCGGTCGTGTCTAGTCC
CTCATCATGCTATGGAGGA -> TCATCATGCTATGGAGGAC
TTGTCGGGATCAAGCCTAT -> TGTCGGGATCAAGCCTATA
CAGCAATGAGGTAGTGTCG -> AGCAATGAGGTAGTGTCGA
TGGAGGACGGAGACGAACT -> GGAGGACGGAGACGAACTG
TACGCTGCACGTTTACATG -> ACGCTGCACGTTTACATGT
CCGCATCCCGGTCGTGTCT -> CGCATCCCGGTCGTGTCTA
CCTTCATTTCTGAGTAGTT -> CTTCATTTCTGAGTAGTTG
TCGTAGCGACGGGTGATAT -> CGTAGCGACGGGTGATATA
CTATGCTACCCAAGTGGCT -> TATGCTACCCAAGTGGCTT
ATTGGGGAGACTCCCTGCA -> TTGGGGAGACTCCCTGCAT
CTGCGGGACGATCCTGAAA -> TGCGGGACGATCCTGAAAT
CGTGTCTAGTTTCGGCACC -> GTGTCTAGTTTCGGCACCA
CGGTCGTGTCTAGTAAGCT -> GGTCGTGTCTAGTAAGCTT
ACACGGCCCTGAACTCTAA -> CACGGCCCTGAACTCTAAA
GCCCCTAATAATAAATCTT -> CCCCTAATAATAAATCTTA
GCAATGATTGGGTAACTTG -> CAATGATTGGGTAACTTGA
ATACTGTAAGGACGCTCAG -> TACTGTAAGGACGCTCAGC
GTAAGCTTTTTAGCTAGAA -> TAAGCTTTTTAGCTAGAAG
TCCTAACTATCCTATACGC -> CCTAACTATCCTATACGCG
CATTACATATTTTAATCCC -> ATTACATATTTTAATCCCG
GATTCCTCATCAGCAATGA -> ATTCCTCATCAGCAATGAG
TGTTTCCGCCAGCCGCCGG -> GTTTCCGCCAGCCGCCGGG
CCTAACTATCCTATACGCG -> CTAACTATCCTATACGCGT
CCGCCAATTGCAAGACACA -> CGCCAATTGCAAGACACAC
TTAGCACATTCCGTCCAAG -> TAGCACATTCCGTCCAAGA
AATTGCCACTCGATATGTC -> ATTGCCACTCGATATGTCA
GTTGTACAGCAAACAACTG -> TTGTACAGCAAACAACTGA
GACTCTTCGCTTTTACAAA -> ACTCTTCGCTTTTACAAAA
CCGGGTCTGTGAAACTATA -> CGGGTCTGTGAAACTATAC
AATCCTTTCGGGGGCATCG -> ATCCTTTCGGGGGCATCGG
AGTAAGCTTTTTAGCTAGA -> GTAAGCTTTTTAGCTAGAA
GCGGAATTCTCCTGATGTG -> CGGAATTCTCCTGATGTGT
TGGGCCACTCAGGCCTTAG -> GGGCCACTCAGGCCTTAGC
GAATTATGTGGCGAATGTT -> AATTATGTGGCGAATGTTA
ACGGTTCGTCCACAAGGAG -> CGGTTCGTCCACAAGGAGC
TGTCCTGCCAACGGAATCG -> GTCCTGCCAACGGAATCGC
CCTATAAACGTCCCGTCGG -> CTATAAACGTCCCGTCGGT
TCTATTTCGTGTAGAGCAA -> CTATTTCGTGTAGAGCAAT
CCAGGCCATTTCTTTAGTT -> CAGGCCATTTCTTTAGTTC
ACTGAAATTAGTTTGTAGA -> CTGAAATTAGTTTGTAGAG
CGTTACGTGATTTAATATT -> GTTACGTGATTTAATATTG
TAGAGGTGTGCGCCTCACA -> AGAGGTGTGCGCCTCACAG
GTTGTAGAATTCAACCCCC -> TTGTAGAATTCAACCCCCG
CGCACATATGTTTCGTCGA -> GCACATATGTTTCGTCGAA
TCAAGGTTTGTTGAAGTCG -> CAAGGTTTGTTGAAGTCGC
CCACACAAAAGCGACTAGT -> CACACAAAAGCGACTAGTT
CGCGTGATGAGAAGGCCAG -> GCGTGATGAGAAGGCCAGA
CTATTTCGTGTAGAGCAAT -> TATTTCGTGTAGAGCAATT
ATACCTTCATTTCTGAGTA -> TACCTTCATTTCTGAGTAG
GACTTCCTAAAAGAGTACG -> ACTTCCTAAAAGAGTACGC
TCATCAGCAATGAGGTAGT -> CATCAGCAATGAGGTAGTG
GTAGGAGCTACCCGGATAC -> TAGGAGCTACCCGGATACT
AAATTAAGAAATCCGTAGG -> AATTAAGAAATCCGTAGGA
GCACATTCCGTCCAAGAGA -> CACATTCCGTCCAAGAGAG
CCGTCCAAGAGAGGGACTC -> CGTCCAAGAGAGGGACTCA
TGTTGAAGTCGCAAACGGC -> GTTGAAGTCGCAAACGGCT
ATACGCTAGAAGAGGCCCT -> TACGCTAGAAGAGGCCCTC
GCCGGTTGTAGAATTCAAC -> CCGGTTGTAGAATTCAACC
TCTAGTCCTATTGTATGCT -> CTAGTCCTATTGTATGCTA
GCCGGGTCTGTGAAACTAT -> CCGGGTCTGTGAAACTATA
CTATTGGGGACTTCCTAAA -> TATTGGGGACTTCCTAAAA
CATACTTGGGTGTGCCTCT -> ATACTTGGGTGTGCCTCTT
TGGGGCCAGGACATGGGCA -> GGGGCCAGGACATGGGCAG
CACAGAATTATGTGGCGAA -> ACAGAATTATGTGGCGAAT
CGAGTTTACATAGGCTCTC -> GAGTTTACATAGGCTCTCC
GCCTTGGATGTTTGCCGTT -> CCTTGGATGTTTGCCGTTA
CCTCTACGGTTCGTCCACA -> CTCTACGGTTCGTCCACAA
GCAATGGGAACCCAATGTT -> CAATGGGAACCCAATGTTA
CAAACGGCTGCGGGACGAT -> AAACGGCTGCGGGACGATC
ATCTTATACCACGTCGAGC -> TCTTATACCACGTCGAGCC
TCATCATGCTATGGAGGAC -> CATCATGCTATGGAGGACG
TCGCAAATCCTTTCGGGGG -> CGCAAATCCTTTCGGGGGC
GCTTACTGAAATTAGTTTG -> CTTACTGAAATTAGTTTGT
CGACCAAATCGCACATATG -> GACCAAATCGCACATATGT
GAAGCCTTGGATGTTTGCC -> AAGCCTTGGATGTTTGCCG
AGCAATGATTGGGTAACTT -> GCAATGATTGGGTAACTTG
ATGCGGCGGCGAATCGTAG -> TGCGGCGGCGAATCGTAGC
GGTCCAGGCCATTTCTTTA -> GTCCAGGCCATTTCTTTAG
AAAGGACTCAGGACGGCAT -> AAGGACTCAGGACGGCATG
ATGGAGATGGAGCGTAGCC -> TGGAGATGGAGCGTAGCCC
TCAGGATGCAGTCGCAAAT -> CAGGATGCAGTCGCAAATC
TTCCGTCCAAGAGAGGGAC -> TCCGTCCAAGAGAGGGACT
GCTACCCGGATACTGTAAG -> CTACCCGGATACTGTAAGG
CGTCCACAAGGAGCCGGCT -> GTCCACAAGGAGCCGGCTT
TTTCGTCGAAGAGCGTGAG -> TTCGTCGAAGAGCGTGAGG
CTAAAAGAGTACGCAATTG -> TAAAAGAGTACGCAATTGT
TAGTGGCACAATTGTCTAT -> AGTGGCACAATTGTCTATT
ATTTTATGCGTTTATTTAG -> TTTTATGCGTTTATTTAGT
AACTATCCTATACGCGTAG -> ACTATCCTATACGCGTAGC
TTCTTTAGTTCCCGATGAA -> TCTTTAGTTCCCGATGAAG
CTGCAAGTCACGTGGGATT -> TGCAAGTCACGTGGGATTC
GAAGTCGCAAACGGCTGCG -> AAGTCGCAAACGGCTGCGG
TCGTCGAAGAGCGTGAGGC -> CGTCGAAGAGCGTGAGGCA
GGTCGTGTCTAGTTTCGGC -> GTCGTGTCTAGTTTCGGCA
TGCCGGTTGTAGAATTCAA -> GCCGGTTGTAGAATTCAAC
ACAGTGGAATGTTCAAGGT -> CAGTGGAATGTTCAAGGTT
TTGGATGTTTGCCGTTAAG -> TGGATGTTTGCCGTTAAGC
CGCTAGAAGAGGCCCTCCG -> GCTAGAAGAGGCCCTCCGG
CGGAGCCGGTTTATGGAGA -> GGAGCCGGTTTATGGAGAT
TAGTATTTTATGCGTTTAT -> AGTATTTTATGCGTTTATT
CTTCATTTCTGAGTAGTTG -> TTCATTTCTGAGTAGTTGA
CGTAGGAGCTACCCGGATA -> GTAGGAGCTACCCGGATAC
TGGAGCGTAGCCCCTAATA -> GGAGCGTAGCCCCTAATAA
TCGTAGACTAAATTCGACT -> CGTAGACTAAATTCGACTC
TATTCCCGACATTTCGTAG -> ATTCCCGACATTTCGTAGA
AGAGGCCCTCCGGCTTTAG -> GAGGCCCTCCGGCTTTAGC
GCGGCGAATCGTAGCGACG -> CGGCGAATCGTAGCGACGG
GCAATTGCCACTCGATATG -> CAATTGCCACTCGATATGT
GCTGCGCCCACCGCATCCC -> CTGCGCCCACCGCATCCCG
TATGTGGCGAATGTTAGCA -> ATGTGGCGAATGTTAGCAC
CGGCATGGTATTACTCCGG -> GGCATGGTATTACTCCGGC
TTTGTTGTTGTATACAAAA -> TTGTTGTTGTATACAAAAG
GCGACTAGTTTCAGATAGC -> CGACTAGTTTCAGATAGCA
GCTAATGCAGACGCGTCTG -> CTAATGCAGACGCGTCTGC
CCCGCAAGCATCAGGATGC -> CCGCAAGCATCAGGATGCA
TCAGTTAGTAGTATTTTAT -> CAGTTAGTAGTATTTTATG
AAATCCTTTCGGGGGCATC -> AATCCTTTCGGGGGCATCG
GTTTGTTGAAGTCGCAAAC -> TTTGTTGAAGTCGCAAACG
CGATTGGTTGCTGGTTGTA -> GATTGGTTGCTGGTTGTAC
TGCGTTACGTGATTTAATA -> GCGTTACGTGATTTAATAT
CGTCTTATTTTCATTGATC -> GTCTTATTTTCATTGATCC
TAAATTCGACTCTTCGCTT -> AAATTCGACTCTTCGCTTT
TAATGCAGACGCGTCTGCA -> AATGCAGACGCGTCTGCAA
TGGGGACTTCCTAAAAGAG -> GGGGACTTCCTAAAAGAGT
ACGGCTGCGGGACGATCCT -> CGGCTGCGGGACGATCCTG
CTACCCAAGTGGCTTGCTC -> TACCCAAGTGGCTTGCTCA
CGCACTTAGACCAGGCAAT -> GCACTTAGACCAGGCAATG
TCATCCTAACTATCCTATA -> CATCCTAACTATCCTATAC
CCGGTCGTGTCTAGTGCAC -> CGGTCGTGTCTAGTGCACT
ATAACGTTACTCCCGCAAG -> TAACGTTACTCCCGCAAGC
AATCGTAGCGACGGGTGAT -> ATCGTAGCGACGGGTGATA
TAGCGATGGTACCTTTAGT -> AGCGATGGTACCTTTAGTC
CGCAATTGTTGTTTCCGCC -> GCAATTGTTGTTTCCGCCA
CCTGAAATAAATCGCGAAG -> CTGAAATAAATCGCGAAGA
CGTCGGTCCAGGCTTCTCA -> GTCGGTCCAGGCTTCTCAT
TGGCACAATTGTCTATTTC -> GGCACAATTGTCTATTTCG
GAGAGCTGGCTGCGCCCAC -> AGAGCTGGCTGCGCCCACC
CAGACGCGTCTGCAACCGC -> AGACGCGTCTGCAACCGCG
GTAGCAATGATTGGGTAAC -> TAGCAATGATTGGGTAACT
ACGGACATTGGTGTCTTGT -> CGGACATTGGTGTCTTGTA
GTTGACCTACCTGGGCCAC -> TTGACCTACCTGGGCCACT
TGTGAGGATAAAGCGTACC -> GTGAGGATAAAGCGTACCT
CTAAAAAACTACCCTATTG -> TAAAAAACTACCCTATTGG
AGATAGCACCCGCACTACC -> GATAGCACCCGCACTACCA
TGCGAAAGCAGTACTAGCC -> GCGAAAGCAGTACTAGCCC
TACAAAAGGACTCAGGACG -> ACAAAAGGACTCAGGACGG
ACAGCAAACAACTGAACAG -> CAGCAAACAACTGAACAGT
TTGACCCTTTTCCGGCTTG -> TGACCCTTTTCCGGCTTGT
GGCGGCGAATCGTAGCGAC -> GCGGCGAATCGTAGCGACG
AGCACATTCCGTCCAAGAG -> GCACATTCCGTCCAAGAGA
TCGTGCCGTCGGTCCAGGC -> CGTGCCGTCGGTCCAGGCT
CCCTGCATGAAGGTCTTGA -> CCTGCATGAAGGTCTTGAT
GTCGTGTCTAGTGCACTAA -> TCGTGTCTAGTGCACTAAT
GTACTAGCCCACAGTGGAA -> TACTAGCCCACAGTGGAAT
GACATTTCGTAGACTAAAT -> ACATTTCGTAGACTAAATT
CGCTCAGCTCGACACGGCC -> GCTCAGCTCGACACGGCCC
TGATCGCGTGATGAGAAGG -> GATCGCGTGATGAGAAGGC
GGGGCCAGGACATGGGCAG -> GGGCCAGGACATGGGCAGG
CTCCCGCAAGCATCAGGAT -> TCCCGCAAGCATCAGGATG
ATCGCGTGATGAGAAGGCC -> TCGCGTGATGAGAAGGCCA
AGCCTATAAACGTCCCGTC -> GCCTATAAACGTCCCGTCG
CGGAGGGGCAGGGTGCGTT -> GGAGGGGCAGGGTGCGTTA
TGAAATTAGTTTGTAGAGG -> GAAATTAGTTTGTAGAGGT
GTTTGTAGAGGTGTGCGCC -> TTTGTAGAGGTGTGCGCCT
GTGCGCCTCACAGAATTAT -> TGCGCCTCACAGAATTATG
GAAGGCCAGATCCGAGTTT -> AAGGCCAGATCCGAGTTTA
TACTCCCGCAAGCATCAGG -> ACTCCCGCAAGCATCAGGA
GGATACTGTAAGGACGCTC -> GATACTGTAAGGACGCTCA
GCGCTATTAACATAGACAC -> CGCTATTAACATAGACACA
GGGGCAGGGTGCGTTACGT -> GGGCAGGGTGCGTTACGTG
CTTGTAGGGCATGGGCGGA -> TTGTAGGGCATGGGCGGAA
ATTTAGTGGCACAATTGTC -> TTTAGTGGCACAATTGTCT
GTCACTCGGGGAGTATGCG -> TCACTCGGGGAGTATGCGG
CACCCGCACTACCATTGCT -> ACCCGCACTACCATTGCTT
CCACAAGGAGCCGGCTTGC -> CACAAGGAGCCGGCTTGCG
ATTAAAATTTATTCCCGAC -> TTAAAATTTATTCCCGACA
CGATCCTGAAATTAAGAAA -> GATCCTGAAATTAAGAAAT
TCTTGATCGCGTGATGAGA -> CTTGATCGCGTGATGAGAA
CAATGTTAACCAACGGCTG -> AATGTTAACCAACGGCTGT
ATTTTCATTGATCCCGGTC -> TTTTCATTGATCCCGGTCG
AATCGCGGAATTCTCCTGA -> ATCGCGGAATTCTCCTGAT
TGTTGTATACAAAAGGACT -> GTTGTATACAAAAGGACTC
ACGATCCTGAAATTAAGAA -> CGATCCTGAAATTAAGAAA
CGGTCACTCGGGGAGTATG -> GGTCACTCGGGGAGTATGC
TCTAAAAAACTACCCTATT -> CTAAAAAACTACCCTATTG
AATCTTATACCACGTCGAG -> ATCTTATACCACGTCGAGC
ACCTACCTGGGCCACTCAG -> CCTACCTGGGCCACTCAGG
AATTCGACTCTTCGCTTTT -> ATTCGACTCTTCGCTTTTA
AGCTTACTGAAATTAGTTT -> GCTTACTGAAATTAGTTTG
AATAAATCTTATACCACGT -> ATAAATCTTATACCACGTC
TGTTTGACCATCTAAGCTG -> GTTTGACCATCTAAGCTGC
ATTTCTGCGATGCCGGTTG -> TTTCTGCGATGCCGGTTGT
CACTCGATATGTCATACTT -> ACTCGATATGTCATACTTG
CAATTGTTGTTTCCGCCAG -> AATTGTTGTTTCCGCCAGC
CCAAGCATACGGACATTGG -> CAAGCATACGGACATTGGT
CGGCGATTGGCATTACATA -> GGCGATTGGCATTACATAT
CGCTAATGCAGACGCGTCT -> GCTAATGCAGACGCGTCTG
CCCGGTCGTGTCTAGTCCT -> CCGGTCGTGTCTAGTCCTA
TTCGACTCTTCGCTTTTAC -> TCGACTCTTCGCTTTTACA
ATCGAAGCCTTGGATGTTT -> TCGAAGCCTTGGATGTTTG
TGGGCAGGCGTCTTATTTT -> GGGCAGGCGTCTTATTTTC
GCATTACATATTTTAATCC -> CATTACATATTTTAATCCC
GAAAGCTTACTGAAATTAG -> AAAGCTTACTGAAATTAGT
TTCCTCATCAGCAATGAGG -> TCCTCATCAGCAATGAGGT
GGGGAGTATGCGGCGGCGA -> GGGAGTATGCGGCGGCGAA
GTCATACTTGGGTGTGCCT -> TCATACTTGGGTGTGCCTC
CCAGATCCGAGTTTACATA -> CAGATCCGAGTTTACATAG
TCTTGCACGATCCGCCAAT -> CTTGCACGATCCGCCAATT
ACATTTCGTAGACTAAATT -> CATTTCGTAGACTAAATTC
TACAAAATTAGCGATGGTA -> ACAAAATTAGCGATGGTAC
GTAGAATTCAACCCCCGCG -> TAGAATTCAACCCCCGCGT
CCACCCAGTTCGGAGCCGG -> CACCCAGTTCGGAGCCGGT
TGAGGATAAAGCGTACCTG -> GAGGATAAAGCGTACCTGG
AGTTTACATAGGCTCTCCC -> GTTTACATAGGCTCTCCCT
ATTACCTCTACGGTTCGTC -> TTACCTCTACGGTTCGTCC
TAGAATTCAACCCCCGCGT -> AGAATTCAACCCCCGCGTG
TCTAGTTTCGGCACCAACT -> CTAGTTTCGGCACCAACTA
GCAGGGTGCGTTACGTGAT -> CAGGGTGCGTTACGTGATT
AAACTACCCTATTGGGGAC -> AACTACCCTATTGGGGACT
GCCGTCGGTCCAGGCTTCT -> CCGTCGGTCCAGGCTTCTC
TCGTGTCTAGTGCACTAAT -> CGTGTCTAGTGCACTAATA
GCTATTAACATAGACACAA -> CTATTAACATAGACACAAT
ACACAATTACCTCTACGGT -> CACAATTACCTCTACGGTT
GCGAAGAGCCTGCCCACTG -> CGAAGAGCCTGCCCACTGC
TCCAGGCCATTTCTTTAGT -> CCAGGCCATTTCTTTAGTT
TTTAGTTCCCGATGAAGCA -> TTAGTTCCCGATGAAGCAA
TCTTGTAGGGCATGGGCGG -> CTTGTAGGGCATGGGCGGA
TATGTCATACTTGGGTGTG -> ATGTCATACTTGGGTGTGC
CTGCAGGGGCACGTGTCGA -> TGCAGGGGCACGTGTCGAC
TCAACCCCCGCGTGTGGGG -> CAACCCCCGCGTGTGGGGC
AATACCTTCATTTCTGAGT -> ATACCTTCATTTCTGAGTA
AAGCAGTACTAGCCCACAG -> AGCAGTACTAGCCCACAGT
GCACCAACTAGAAGAGGCC -> CACCAACTAGAAGAGGCCC
GGCATGGTATTACTCCGGC -> GCATGGTATTACTCCGGCG
TCCAAGAGAGGGACTCAAA -> CCAAGAGAGGGACTCAAAT
AGCATCAGGATGCAGTCGC -> GCATCAGGATGCAGTCGCA
GGCCCTCCGGCGGAGGGGC -> GCCCTCCGGCGGAGGGGCA
AGTGGCTTGCTCATCATGC -> GTGGCTTGCTCATCATGCT
ATTAAGAAATCCGTAGGAG -> TTAAGAAATCCGTAGGAGC
TCCGGCGGAGGGGCAGGGT -> CCGGCGGAGGGGCAGGGTG
GCCAGATCCGAGTTTACAT -> CCAGATCCGAGTTTACATA
GATAGCACCCGCACTACCA -> ATAGCACCCGCACTACCAT
ACCTTTAGTCAGTTAGTAG -> CCTTTAGTCAGTTAGTAGT
CTATACAAAGACGCACTTA -> TATACAAAGACGCACTTAG
GCCTATAAACGTCCCGTCG -> CCTATAAACGTCCCGTCGG
TGTAGGGCATGGGCGGAAA -> GTAGGGCATGGGCGGAAAG
CGAACTGTCCAAGCATACG -> GAACTGTCCAAGCATACGG
TTAATCCCGGTCGTGTCTA -> TAATCCCGGTCGTGTCTAG
GCGTAGCTCTCGTGCCGTC -> CGTAGCTCTCGTGCCGTCG
CCGGTCGTGTCTAGTTTCG -> CGGTCGTGTCTAGTTTCGG
GACCAAATCGCACATATGT -> ACCAAATCGCACATATGTT
GTACCTGGTGAGGTCTTAC -> TACCTGGTGAGGTCTTACT
ACGCGTAGCTCTCGTGCCG -> CGCGTAGCTCTCGTGCCGT
TCGGGGCACTCGTTGACCT -> CGGGGCACTCGTTGACCTA
CCTATTGTATGCTAGAAGA -> CTATTGTATGCTAGAAGAG
TCCAAGCATACGGACATTG -> CCAAGCATACGGACATTGG
TGTATACAAAAGGACTCAG -> GTATACAAAAGGACTCAGG
CAATTGCCACTCGATATGT -> AATTGCCACTCGATATGTC
ATCCGTAGGAGCTACCCGG -> TCCGTAGGAGCTACCCGGA
TCCAGGCTTCTCATCTTTC -> CCAGGCTTCTCATCTTTCA
ACAACTGAACAGTAAACGA -> CAACTGAACAGTAAACGAA
GTGTCTAGTGCACTAATAC -> TGTCTAGTGCACTAATACG
CCCGTCGGTCACTCGGGGA -> CCGTCGGTCACTCGGGGAG
GAGCCGGTTTATGGAGATG -> AGCCGGTTTATGGAGATGG
TTCCCGACATTTCGTAGAC -> TCCCGACATTTCGTAGACT
TGCGAATACCTTCATTTCT -> GCGAATACCTTCATTTCTG
GCTGCGGGACGATCCTGAA -> CTGCGGGACGATCCTGAAA
CCGGCTTGTCGGGATCAAG -> CGGCTTGTCGGGATCAAGC
TTGTAGAGGTGTGCGCCTC -> TGTAGAGGTGTGCGCCTCA
CACATATGTTTCGTCGAAG -> ACATATGTTTCGTCGAAGA
TATTGGGGAGACTCCCTGC -> ATTGGGGAGACTCCCTGCA
CATATTTTAATCCCGGTCG -> ATATTTTAATCCCGGTCGT
GGATGTTTGCCGTTAAGCT -> GATGTTTGCCGTTAAGCTC
AAAGAGTACGCAATTGTTG -> AAGAGTACGCAATTGTTGT
AAATTAGCGATGGTACCTT -> AATTAGCGATGGTACCTTT
TTGTAGAATTCAACCCCCG -> TGTAGAATTCAACCCCCGC
TCCCTTGCGATTGGTTGCT -> CCCTTGCGATTGGTTGCTG
AATAATAAATCTTATACCA -> ATAATAAATCTTATACCAC
ATAGGCTCTCCCTTGCGAT -> TAGGCTCTCCCTTGCGATT
ACTATCCTATACGCGTAGC -> CTATCCTATACGCGTAGCT
TGCCGTCGGTCCAGGCTTC -> GCCGTCGGTCCAGGCTTCT
ATACCACGTCGAGCCTCCG -> TACCACGTCGAGCCTCCGC
TGTCCAAGCATACGGACAT -> GTCCAAGCATACGGACATT
ACTGGATTCTCGGGTTTTC -> CTGGATTCTCGGGTTTTCC
GAAATTAGTTTGTAGAGGT -> AAATTAGTTTGTAGAGGTG
GCACTTCCAATCCCTGTAG -> CACTTCCAATCCCTGTAGC
TAAATCTTATACCACGTCG -> AAATCTTATACCACGTCGA
CCCACAGTGGAATGTTCAA -> CCACAGTGGAATGTTCAAG
GAGGTGTGCGCCTCACAGA -> AGGTGTGCGCCTCACAGAA
TAAGTTATTCGGCGATTGG -> AAGTTATTCGGCGATTGGC
GATACTGTAAGGACGCTCA -> ATACTGTAAGGACGCTCAG
TGTAGCAATGATTGGGTAA -> GTAGCAATGATTGGGTAAC
TGCGATTGGTTGCTGGTTG -> GCGATTGGTTGCTGGTTGT
TGGCGAATGTTAGCACATT -> GGCGAATGTTAGCACATTC
CTAGTTTCGGCACCAACTA -> TAGTTTCGGCACCAACTAG
ATTCGGCGATTGGCATTAC -> TTCGGCGATTGGCATTACA
TGTTAACCAACGGCTGTGA -> GTTAACCAACGGCTGTGAT
CAACCGCGCTATGCTACCC -> AACCGCGCTATGCTACCCA
GCGATGCCGGTTGTAGAAT -> CGATGCCGGTTGTAGAATT
TTTATGCGTTTATTTAGTG -> TTATGCGTTTATTTAGTGG
ACGCATTAGTGGCGCTATT -> CGCATTAGTGGCGCTATTA
GGCATCGGGGCACTCGTTG -> GCATCGGGGCACTCGTTGA
ATCGCACATATGTTTCGTC -> TCGCACATATGTTTCGTCG
CACGTGGGATTCCTCATCA -> ACGTGGGATTCCTCATCAG
TTTAATCCCGGTCGTGTCT -> TTAATCCCGGTCGTGTCTA
TCTAGTAAGCTTTTTAGCT -> CTAGTAAGCTTTTTAGCTA
ACTCCCTGCATGAAGGTCT -> CTCCCTGCATGAAGGTCTT
GACTTTGTTGTTGTATACA -> ACTTTGTTGTTGTATACAA
GACTCCCTGCATGAAGGTC -> ACTCCCTGCATGAAGGTCT
ACGTGATTTAATATTGGGG -> CGTGATTTAATATTGGGGA
TGATGAGAAGGCCAGATCC -> GATGAGAAGGCCAGATCCG
ATAATAAATCTTATACCAC -> TAATAAATCTTATACCACG
TAGAAGAGGCCCTCCGGCG -> AGAAGAGGCCCTCCGGCGG
CGGTTGTAGAATTCAACCC -> GGTTGTAGAATTCAACCCC
CGTCCCGTCGGTCACTCGG -> GTCCCGTCGGTCACTCGGG
ATGGGAACCCAATGTTAAC -> TGGGAACCCAATGTTAACC
GCACCCGCACTACCATTGC -> CACCCGCACTACCATTGCT
GAAGAGCGTGAGGCACTTC -> AAGAGCGTGAGGCACTTCC
CTCGCTAATGCAGACGCGT -> TCGCTAATGCAGACGCGTC
TACGCTAGAAGAGGCCCTC -> ACGCTAGAAGAGGCCCTCC
CACTCAGGCCTTAGCTGTT -> ACTCAGGCCTTAGCTGTTA
CGCACTACCATTGCTTAAG -> GCACTACCATTGCTTAAGT
AATCCCAACCCTGAAATAA -> ATCCCAACCCTGAAATAAA
AGTCACGTGGGATTCCTCA -> GTCACGTGGGATTCCTCAT
AAGTCACGTGGGATTCCTC -> AGTCACGTGGGATTCCTCA
CGCATCCCGGTCGTGTCTA -> GCATCCCGGTCGTGTCTAG
GCGATTGGCATTACATATT -> CGATTGGCATTACATATTT
ACTACCATTGCTTAAGTTA -> CTACCATTGCTTAAGTTAT
AGCTGTTATACGCTGCACG -> GCTGTTATACGCTGCACGT
CAGTTCGGAGCCGGTTTAT -> AGTTCGGAGCCGGTTTATG
TCTTACTATTAAAATTTAT -> CTTACTATTAAAATTTATT
ATTCTCGGGTTTTCCACAC -> TTCTCGGGTTTTCCACACA
AGGCTCTCCCTTGCGATTG -> GGCTCTCCCTTGCGATTGG
TTACATGTTTGACCATCTA -> TACATGTTTGACCATCTAA
TGCGGGACGATCCTGAAAT -> GCGGGACGATCCTGAAATT
TAGTTTGTAGAGGTGTGCG -> AGTTTGTAGAGGTGTGCGC
TGTCGGGATCAAGCCTATA -> GTCGGGATCAAGCCTATAA
TTTCTGAGTAGTTGACCCT -> TTCTGAGTAGTTGACCCTT
CATCGAAGCCTTGGATGTT -> ATCGAAGCCTTGGATGTTT
CAGGGTCATCCTAACTATC -> AGGGTCATCCTAACTATCC
TGCACGATCCGCCAATTGC -> GCACGATCCGCCAATTGCA
ACGTGGGATTCCTCATCAG -> CGTGGGATTCCTCATCAGC
CCATTTCTTTAGTTCCCGA -> CATTTCTTTAGTTCCCGAT
GTCCCGTCGGTCACTCGGG -> TCCCGTCGGTCACTCGGGG
GGCGGAGGGGCAGGGTGCG -> GCGGAGGGGCAGGGTGCGT
TCGTGTAGAGCAATTGCCA -> CGTGTAGAGCAATTGCCAC
TATGGAGGACGGAGACGAA -> ATGGAGGACGGAGACGAAC
TTATACGCTGCACGTTTAC -> TATACGCTGCACGTTTACA
CGTCGAAGAGCGTGAGGCA -> GTCGAAGAGCGTGAGGCAC
CTTGGGTGTGCCTCTTCAC -> TTGGGTGTGCCTCTTCACG
CTCTAAAAAACTACCCTAT -> TCTAAAAAACTACCCTATT
TTCGGCGATTGGCATTACA -> TCGGCGATTGGCATTACAT
TGTACAGCAAACAACTGAA -> GTACAGCAAACAACTGAAC
CAAGAGAGGGACTCAAATG -> AAGAGAGGGACTCAAATGG
GTTGTTTCCGCCAGCCGCC -> TTGTTTCCGCCAGCCGCCG
TTAAGCTCGAGAGCTGGCT -> TAAGCTCGAGAGCTGGCTG
CGGGGAGTATGCGGCGGCG -> GGGGAGTATGCGGCGGCGA
CCAGGCTTCTCATCTTTCA -> CAGGCTTCTCATCTTTCAA
AGGGACTCAAATGGTCCAG -> GGGACTCAAATGGTCCAGG
CTTAGACCAGGCAATGGGA -> TTAGACCAGGCAATGGGAA
AGTTATTCGGCGATTGGCA -> GTTATTCGGCGATTGGCAT
AATTCTCCTGATGTGTAAA -> ATTCTCCTGATGTGTAAAT
TTGTATACAAAAGGACTCA -> TGTATACAAAAGGACTCAG
GTAGGGCATGGGCGGAAAG -> TAGGGCATGGGCGGAAAGC
CAGTTATTGCCGTGGGCAT -> AGTTATTGCCGTGGGCATC
TTAGACCAGGCAATGGGAA -> TAGACCAGGCAATGGGAAC
CCCGACATTTCGTAGACTA -> CCGACATTTCGTAGACTAA
GCTACCCAAGTGGCTTGCT -> CTACCCAAGTGGCTTGCTC
GAAATTAAGAAATCCGTAG -> AAATTAAGAAATCCGTAGG
GGTCTTACTATTAAAATTT -> GTCTTACTATTAAAATTTA
GCCCACCGCATCCCGGTCG -> CCCACCGCATCCCGGTCGT
GGGGCACGTGTCGACACTG -> GGGCACGTGTCGACACTGG
TAATCCCGGTCGTGTCTAG -> AATCCCGGTCGTGTCTAGT
CAAACAACTGAACAGTAAA -> AAACAACTGAACAGTAAAC
TCCCGACATTTCGTAGACT -> CCCGACATTTCGTAGACTA
CATCCCGGTCGTGTCTAGT -> ATCCCGGTCGTGTCTAGTC
TATGTTTCGTCGAAGAGCG -> ATGTTTCGTCGAAGAGCGT
CGGCGAATCGTAGCGACGG -> GGCGAATCGTAGCGACGGG
CGAGAGCTGGCTGCGCCCA -> GAGAGCTGGCTGCGCCCAC
CGATGAAGCAAGTACCATA -> GATGAAGCAAGTACCATAG
AGTAAACGAACTGTGAGGA -> GTAAACGAACTGTGAGGAT
GCGCAAAATGCTCGCTAAT -> CGCAAAATGCTCGCTAATG
CATAGTACAGAACTGCAGG -> ATAGTACAGAACTGCAGGG
TTAGCCGTCAGGGTCATCC -> TAGCCGTCAGGGTCATCCT
ATGGGCAGGCGTCTTATTT -> TGGGCAGGCGTCTTATTTT
AGGGCATGGGCGGAAAGCT -> GGGCATGGGCGGAAAGCTT
CCGGATACTGTAAGGACGC -> CGGATACTGTAAGGACGCT
TCGATATGTCATACTTGGG -> CGATATGTCATACTTGGGT
TGCGTTTATTTAGTGGCAC -> GCGTTTATTTAGTGGCACA
AAACGGCTGCGGGACGATC -> AACGGCTGCGGGACGATCC
AATTAGCGATGGTACCTTT -> ATTAGCGATGGTACCTTTA
AAGACGCACTTAGACCAGG -> AGACGCACTTAGACCAGGC
CGACACGGCCCTGAACTCT -> GACACGGCCCTGAACTCTA
TCGAAGAGCGTGAGGCACT -> CGAAGAGCGTGAGGCACTT
TAGCTCTCGTGCCGTCGGT -> AGCTCTCGTGCCGTCGGTC
CGATATCCCGGTCGTGTCT -> GATATCCCGGTCGTGTCTA
CACAAAAGCGACTAGTTTC -> ACAAAAGCGACTAGTTTCA
TACATATTTTAATCCCGGT -> ACATATTTTAATCCCGGTC
ACTAGCCCACAGTGGAATG -> CTAGCCCACAGTGGAATGT
CTGAAATTAGTTTGTAGAG -> TGAAATTAGTTTGTAGAGG
CAGCAAACAACTGAACAGT -> AGCAAACAACTGAACAGTA
AGTTCCCGATGAAGCAAGT -> GTTCCCGATGAAGCAAGTA
TCCGCTTATGCGAAAGCAG -> CCGCTTATGCGAAAGCAGT
TCGTGTCTAGTAAGCTTTT -> CGTGTCTAGTAAGCTTTTT
CGCTTTTACAAAATTAGCG -> GCTTTTACAAAATTAGCGA
GTCTAGTGCACTAATACGC -> TCTAGTGCACTAATACGCT
TGAAACTATACAAAGACGC -> GAAACTATACAAAGACGCA
GGAAAGCTTACTGAAATTA -> GAAAGCTTACTGAAATTAG
TTAGTTCCCGATGAAGCAA -> TAGTTCCCGATGAAGCAAG
CGTGAGGCACTTCCAATCC -> GTGAGGCACTTCCAATCCC
GATGTGTAAATCCCAACCC -> ATGTGTAAATCCCAACCCT
ATTTCGTGTAGAGCAATTG -> TTTCGTGTAGAGCAATTGC
ATCAGGATGCAGTCGCAAA -> TCAGGATGCAGTCGCAAAT
TAAGCTTTTTAGCTAGAAG -> AAGCTTTTTAGCTAGAAGA
GCACGATCCGCCAATTGCA -> CACGATCCGCCAATTGCAA
CTGAAATTAAGAAATCCGT -> TGAAATTAAGAAATCCGTA
CTTATTTTCATTGATCCCG -> TTATTTTCATTGATCCCGG
CAAAACTAATCCAGTTATT -> AAAACTAATCCAGTTATTG
ACAAAAGCGACTAGTTTCA -> CAAAAGCGACTAGTTTCAG
TCCCTGCATGAAGGTCTTG -> CCCTGCATGAAGGTCTTGA
GATTGGGTAACTTGAGATA -> ATTGGGTAACTTGAGATAT
TCTAATCGCTGCATCGAAG -> CTAATCGCTGCATCGAAGC
AGAAGAGGCCCTCCGGCCC -> GAAGAGGCCCTCCGGCCCA
ATGTGGCGAATGTTAGCAC -> TGTGGCGAATGTTAGCACA
GGAGGACGGAGACGAACTG -> GAGGACGGAGACGAACTGT
TTGTTTCCGCCAGCCGCCG -> TGTTTCCGCCAGCCGCCGG
GGCACAATTGTCTATTTCG -> GCACAATTGTCTATTTCGT
TACTTGGGTGTGCCTCTTC -> ACTTGGGTGTGCCTCTTCA
AACTGCAGGGGCACGTGTC -> ACTGCAGGGGCACGTGTCG
ACTCCCGCAAGCATCAGGA -> CTCCCGCAAGCATCAGGAT
GGGTGCGTTACGTGATTTA -> GGTGCGTTACGTGATTTAA
AAGCTTACTGAAATTAGTT -> AGCTTACTGAAATTAGTTT
AATGTTAGCACATTCCGTC -> ATGTTAGCACATTCCGTCC
CGAATACCTTCATTTCTGA -> GAATACCTTCATTTCTGAG
CCCTGTAGCAATGATTGGG -> CCTGTAGCAATGATTGGGT
GGTTGTAGAATTCAACCCC -> GTTGTAGAATTCAACCCCC
TCTTATTTTCATTGATCCC -> CTTATTTTCATTGATCCCG
AAGCTGCAAGTCACGTGGG -> AGCTGCAAGTCACGTGGGA
GGGCATCGATTTCTGCGAT -> GGCATCGATTTCTGCGATG
ACTACCCTATTGGGGACTT -> CTACCCTATTGGGGACTTC
TAATCGCTGCATCGAAGCC -> AATCGCTGCATCGAAGCCT
TTGCGAATACCTTCATTTC -> TGCGAATACCTTCATTTCT
GCGTACCTGGTGAGGTCTT -> CGTACCTGGTGAGGTCTTA
CACTGCGCCGATATCCCGG -> ACTGCGCCGATATCCCGGT
CACACAAAAGCGACTAGTT -> ACACAAAAGCGACTAGTTT
CGCTGCATCGAAGCCTTGG -> GCTGCATCGAAGCCTTGGA
TCCCGGTCGTGTCTAGTGC -> CCCGGTCGTGTCTAGTGCA
TAGCCCACAGTGGAATGTT -> AGCCCACAGTGGAATGTTC
ACGTCGAGCCTCCGCTTAT -> CGTCGAGCCTCCGCTTATG
TAGCGACGGGTGATATAAC -> AGCGACGGGTGATATAACG
GCCACTCGATATGTCATAC -> CCACTCGATATGTCATACT
TAGCTAGAAGAGGCCCTCC -> AGCTAGAAGAGGCCCTCCG
GGTCACTCGGGGAGTATGC -> GTCACTCGGGGAGTATGCG
CCAGGACATGGGCAGGCGT -> CAGGACATGGGCAGGCGTC
TTAGTAGTATTTTATGCGT -> TAGTAGTATTTTATGCGTT
GTCGTGTCTAGTAAGCTTT -> TCGTGTCTAGTAAGCTTTT
GTGGGATTCCTCATCAGCA -> TGGGATTCCTCATCAGCAA
CAATTACCTCTACGGTTCG -> AATTACCTCTACGGTTCGT
ACGCTAGAAGAGGCCCTCC -> CGCTAGAAGAGGCCCTCCG
TTCATTGATCCCGGTCGTG -> TCATTGATCCCGGTCGTGT
TCCCTGTAGCAATGATTGG -> CCCTGTAGCAATGATTGGG
AGAGGCCCTCCGGCAAGTG -> GAGGCCCTCCGGCAAGTGG
TTGAGATATCTAATCGCTG -> TGAGATATCTAATCGCTGC
GGATTCTCGGGTTTTCCAC -> GATTCTCGGGTTTTCCACA
CCCTGAACTCTAAAAAACT -> CCTGAACTCTAAAAAACTA
CAGGCAATGGGAACCCAAT -> AGGCAATGGGAACCCAATG
TTAGCTAGAAGAGGCCCTC -> TAGCTAGAAGAGGCCCTCC
ACCCGGATACTGTAAGGAC -> CCCGGATACTGTAAGGACG
GGTAGTGTCGACCAAATCG -> GTAGTGTCGACCAAATCGC
TAGTGGCGCTATTAACATA -> AGTGGCGCTATTAACATAG
AACCAACGGCTGTGATCCA -> ACCAACGGCTGTGATCCAA
AGTACGCAATTGTTGTTTC -> GTACGCAATTGTTGTTTCC
TTACCTCTACGGTTCGTCC -> TACCTCTACGGTTCGTCCA
TACCTTCATTTCTGAGTAG -> ACCTTCATTTCTGAGTAGT
TACTGAAATTAGTTTGTAG -> ACTGAAATTAGTTTGTAGA
AACCCCCGCGTGTGGGGCC -> ACCCCCGCGTGTGGGGCCA
CGTTACTCCCGCAAGCATC -> GTTACTCCCGCAAGCATCA
GGCAATGGGAACCCAATGT -> GCAATGGGAACCCAATGTT
CTTTAGTTCCCGATGAAGC -> TTTAGTTCCCGATGAAGCA
GGGCACGTGTCGACACTGG -> GGCACGTGTCGACACTGGA
CGTTTATTTAGTGGCACAA -> GTTTATTTAGTGGCACAAT
GTCTAGTAAGCTTTTTAGC -> TCTAGTAAGCTTTTTAGCT
ATGAGAAGGCCAGATCCGA -> TGAGAAGGCCAGATCCGAG
CCCAATGTTAACCAACGGC -> CCAATGTTAACCAACGGCT
CTATTGTATGCTAGAAGAG -> TATTGTATGCTAGAAGAGG
ACACAAAAGCGACTAGTTT -> CACAAAAGCGACTAGTTTC
GAGGTAGTGTCGACCAAAT -> AGGTAGTGTCGACCAAATC
ACCAACGGCTGTGATCCAA -> CCAACGGCTGTGATCCAAA
CTAGCCCACAGTGGAATGT -> TAGCCCACAGTGGAATGTT
TGTCTATTTCGTGTAGAGC -> GTCTATTTCGTGTAGAGCA
GCAAGTACCATAGTACAGA -> CAAGTACCATAGTACAGAA
CTTATACCACGTCGAGCCT -> TTATACCACGTCGAGCCTC
AGAGCTGGCTGCGCCCACC -> GAGCTGGCTGCGCCCACCG
TTATGCGAAAGCAGTACTA -> TATGCGAAAGCAGTACTAG
TGAAGCAAGTACCATAGTA -> GAAGCAAGTACCATAGTAC
TGGGATTCCTCATCAGCAA -> GGGATTCCTCATCAGCAAT
AACCCTGAAATAAATCGCG -> ACCCTGAAATAAATCGCGA
AGCCTTGGATGTTTGCCGT -> GCCTTGGATGTTTGCCGTT
GTCTTATTTTCATTGATCC -> TCTTATTTTCATTGATCCC
GATGCCGGTTGTAGAATTC -> ATGCCGGTTGTAGAATTCA
AAGGACGCTCAGCTCGACA -> AGGACGCTCAGCTCGACAC
ACGCACTTAGACCAGGCAA -> CGCACTTAGACCAGGCAAT
CAAGTACCATAGTACAGAA -> AAGTACCATAGTACAGAAC
CTGAGTAGTTGACCCTTTT -> TGAGTAGTTGACCCTTTTC
TAAATCCCAACCCTGAAAT -> AAATCCCAACCCTGAAATA
TCGCTAATGCAGACGCGTC -> CGCTAATGCAGACGCGTCT
AGATATCTAATCGCTGCAT -> GATATCTAATCGCTGCATC
TAGTCCTATTGTATGCTAG -> AGTCCTATTGTATGCTAGA
GGGGCACTCGTTGACCTAC -> GGGCACTCGTTGACCTACC
TTGCCGTTAAGCTCGAGAG -> TGCCGTTAAGCTCGAGAGC
CGTGTCTAGTAAGCTTTTT -> GTGTCTAGTAAGCTTTTTA
GATGGAGCGTAGCCCCTAA -> ATGGAGCGTAGCCCCTAAT
TTTATGGAGATGGAGCGTA -> TTATGGAGATGGAGCGTAG
AAGCATCAGGATGCAGTCG -> AGCATCAGGATGCAGTCGC
ACAGTAAACGAACTGTGAG -> CAGTAAACGAACTGTGAGG
GGCCATTTCTTTAGTTCCC -> GCCATTTCTTTAGTTCCCG
TACGCAATTGTTGTTTCCG -> ACGCAATTGTTGTTTCCGC
AGAACTGCAGGGGCACGTG -> GAACTGCAGGGGCACGTGT
TTGTCTATTTCGTGTAGAG -> TGTCTATTTCGTGTAGAGC
GGCGTCTTATTTTCATTGA -> GCGTCTTATTTTCATTGAT
ACTTGAGATATCTAATCGC -> CTTGAGATATCTAATCGCT
TGCTGGTTGTACAGCAAAC -> GCTGGTTGTACAGCAAACA
CATCTAAGCTGCAAGTCAC -> ATCTAAGCTGCAAGTCACG
GTAAATCCCAACCCTGAAA -> TAAATCCCAACCCTGAAAT
CGAAAGCAGTACTAGCCCA -> GAAAGCAGTACTAGCCCAC
AGGCCAGATCCGAGTTTAC -> GGCCAGATCCGAGTTTACA
TTAGCTGTTATACGCTGCA -> TAGCTGTTATACGCTGCAC
TCTAGTGCACTAATACGCT -> CTAGTGCACTAATACGCTA
CTAATGCAGACGCGTCTGC -> TAATGCAGACGCGTCTGCA
TTTCGGGGGCATCGGGGCA -> TTCGGGGGCATCGGGGCAC
AAATGGTCCAGGCCATTTC -> AATGGTCCAGGCCATTTCT
CTTTCGGGGGCATCGGGGC -> TTTCGGGGGCATCGGGGCA
GACGCACTTAGACCAGGCA -> ACGCACTTAGACCAGGCAA
CGTGTCGACACTGGATTCT -> GTGTCGACACTGGATTCTC
TCCCGCAAGCATCAGGATG -> CCCGCAAGCATCAGGATGC
ACAGAATTATGTGGCGAAT -> CAGAATTATGTGGCGAATG
ATTACTCCGGCGCAAAATG -> TTACTCCGGCGCAAAATGC
TATTGGGGACTTCCTAAAA -> ATTGGGGACTTCCTAAAAG
GCATTGAATACTGCTTATC -> CATTGAATACTGCTTATCT
GTCACGTGGGATTCCTCAT -> TCACGTGGGATTCCTCATC
AACGGAATCGCGGAATTCT -> ACGGAATCGCGGAATTCTC
CCGGTTTATGGAGATGGAG -> CGGTTTATGGAGATGGAGC
TAAACGAACTGTGAGGATA -> AAACGAACTGTGAGGATAA
CACTCGTTGACCTACCTGG -> ACTCGTTGACCTACCTGGG
CATCGGGGCACTCGTTGAC -> ATCGGGGCACTCGTTGACC
TTACAAAATTAGCGATGGT -> TACAAAATTAGCGATGGTA
GGTCGTGTCTAGTAAGCTT -> GTCGTGTCTAGTAAGCTTT
TCTTATACCACGTCGAGCC -> CTTATACCACGTCGAGCCT
GTCGCAAACGGCTGCGGGA -> TCGCAAACGGCTGCGGGAC
GTGTAGAGCAATTGCCACT -> TGTAGAGCAATTGCCACTC
ACAAAAGGACTCAGGACGG -> CAAAAGGACTCAGGACGGC
TTTTACAAAATTAGCGATG -> TTTACAAAATTAGCGATGG
CGGGTGATATAACGTTACT -> GGGTGATATAACGTTACTC
AACAACTGAACAGTAAACG -> ACAACTGAACAGTAAACGA
AAGTGGCTTGCTCATCATG -> AGTGGCTTGCTCATCATGC
TGAGAAGGCCAGATCCGAG -> GAGAAGGCCAGATCCGAGT
TGCAAGTCACGTGGGATTC -> GCAAGTCACGTGGGATTCC
TACCATAGTACAGAACTGC -> ACCATAGTACAGAACTGCA
TGACCATCTAAGCTGCAAG -> GACCATCTAAGCTGCAAGT
ATAGACACAATTACCTCTA -> TAGACACAATTACCTCTAC
CACGTTTACATGTTTGACC -> ACGTTTACATGTTTGACCA
CCGCAAGCATCAGGATGCA -> CGCAAGCATCAGGATGCAG
GCAAGTGGACTTTGTTGTT -> CAAGTGGACTTTGTTGTTG
GCGAATCGTAGCGACGGGT -> CGAATCGTAGCGACGGGTG
AAAATGCTCGCTAATGCAG -> AAATGCTCGCTAATGCAGA
GGGTAACTTGAGATATCTA -> GGTAACTTGAGATATCTAA
AAAGACGCACTTAGACCAG -> AAGACGCACTTAGACCAGG
GGGCCAGGACATGGGCAGG -> GGCCAGGACATGGGCAGGC
CAACGGAATCGCGGAATTC -> AACGGAATCGCGGAATTCT
AAAGCAGTACTAGCCCACA -> AAGCAGTACTAGCCCACAG
AGTAGTATTTTATGCGTTT -> GTAGTATTTTATGCGTTTA
CCAACGGAATCGCGGAATT -> CAACGGAATCGCGGAATTC
GGGTTTTCCACACAAAAGC -> GGTTTTCCACACAAAAGCG
CCTGAACTCTAAAAAACTA -> CTGAACTCTAAAAAACTAC
ATTGCCGTGGGCATCGATT -> TTGCCGTGGGCATCGATTT
GAATTCTCCTGATGTGTAA -> AATTCTCCTGATGTGTAAA
CACGGCCCTGAACTCTAAA -> ACGGCCCTGAACTCTAAAA
AAGGACTCAGGACGGCATG -> AGGACTCAGGACGGCATGG
AAATCCGTAGGAGCTACCC -> AATCCGTAGGAGCTACCCG
CCAAATCGCACATATGTTT -> CAAATCGCACATATGTTTC
CTATACGCGTAGCTCTCGT -> TATACGCGTAGCTCTCGTG
GAGGACGGAGACGAACTGT -> AGGACGGAGACGAACTGTC
CAAAAGCGACTAGTTTCAG -> AAAAGCGACTAGTTTCAGA
GTTTGCCGTTAAGCTCGAG -> TTTGCCGTTAAGCTCGAGA
CGACGGGTGATATAACGTT -> GACGGGTGATATAACGTTA
TAGAAGAGGCCCTCCGGCT -> AGAAGAGGCCCTCCGGCTT
TCCACAAGGAGCCGGCTTG -> CCACAAGGAGCCGGCTTGC
GTTGAAGTCGCAAACGGCT -> TTGAAGTCGCAAACGGCTG
TGCTCGCTAATGCAGACGC -> GCTCGCTAATGCAGACGCG
AGAGGCCCTCCGGCGGAGG -> GAGGCCCTCCGGCGGAGGG
TTTTTAGCTAGAAGAGGCC -> TTTTAGCTAGAAGAGGCCC
CTCAGGCCTTAGCTGTTAT -> TCAGGCCTTAGCTGTTATA
ACAAGGAGCCGGCTTGCGA -> CAAGGAGCCGGCTTGCGAA
CGGTTCGTCCACAAGGAGC -> GGTTCGTCCACAAGGAGCC
CCAATTGCAAGACACACTT -> CAATTGCAAGACACACTTA
TCGAGCCTCCGCTTATGCG -> CGAGCCTCCGCTTATGCGA
GTATGCTAGAAGAGGCCCT -> TATGCTAGAAGAGGCCCTC
CCCTCCGGCAAGTGGACTT -> CCTCCGGCAAGTGGACTTT
TACCACGTCGAGCCTCCGC -> ACCACGTCGAGCCTCCGCT
ACTCCGGCGCAAAATGCTC -> CTCCGGCGCAAAATGCTCG
GAGCCTCCGCTTATGCGAA -> AGCCTCCGCTTATGCGAAA
CGCGTAGCTCTCGTGCCGT -> GCGTAGCTCTCGTGCCGTC
CTTTAGTCAGTTAGTAGTA -> TTTAGTCAGTTAGTAGTAT
CCCTTTTCCGGCTTGTCGG -> CCTTTTCCGGCTTGTCGGG
GAGTATGCGGCGGCGAATC -> AGTATGCGGCGGCGAATCG
TACCCTATTGGGGACTTCC -> ACCCTATTGGGGACTTCCT
TTCAAGGTTTGTTGAAGTC -> TCAAGGTTTGTTGAAGTCG
GTGTCTAGTTTCGGCACCA -> TGTCTAGTTTCGGCACCAA
CCTATACGCGTAGCTCTCG -> CTATACGCGTAGCTCTCGT
ACGAACTGTCCAAGCATAC -> CGAACTGTCCAAGCATACG
GTGTCTAGTAAGCTTTTTA -> TGTCTAGTAAGCTTTTTAG
TGAACAGTAAACGAACTGT -> GAACAGTAAACGAACTGTG
ATATAACGTTACTCCCGCA -> TATAACGTTACTCCCGCAA
TACCTGGGCCACTCAGGCC -> ACCTGGGCCACTCAGGCCT
GTGCCGTCGGTCCAGGCTT -> TGCCGTCGGTCCAGGCTTC
CATTAGTGGCGCTATTAAC -> ATTAGTGGCGCTATTAACA
ACATAGGCTCTCCCTTGCG -> CATAGGCTCTCCCTTGCGA
AGCCGTCAGGGTCATCCTA -> GCCGTCAGGGTCATCCTAA
AAAACTAATCCAGTTATTG -> AAACTAATCCAGTTATTGC
AAGTTATTCGGCGATTGGC -> AGTTATTCGGCGATTGGCA
GTAAACGAACTGTGAGGAT -> TAAACGAACTGTGAGGATA
TGTGCGCCTCACAGAATTA -> GTGCGCCTCACAGAATTAT
ACCCTGAAATAAATCGCGA -> CCCTGAAATAAATCGCGAA
GCCACTCAGGCCTTAGCTG -> CCACTCAGGCCTTAGCTGT
CCGGTCGTGTCTAGTAAGC -> CGGTCGTGTCTAGTAAGCT
TGTCGACCAAATCGCACAT -> GTCGACCAAATCGCACATA
CAAAGACGCACTTAGACCA -> AAAGACGCACTTAGACCAG
CCCCGCGTGTGGGGCCAGG -> CCCGCGTGTGGGGCCAGGA
CAGGCGTCTTATTTTCATT -> AGGCGTCTTATTTTCATTG
ACTAGAAGAGGCCCTCCGG -> CTAGAAGAGGCCCTCCGGC
TCGACCAAATCGCACATAT -> CGACCAAATCGCACATATG
TGGGTGTGCCTCTTCACGC -> GGGTGTGCCTCTTCACGCA
GGATTCCTCATCAGCAATG -> GATTCCTCATCAGCAATGA
TCCCGGTCGTGTCTAGTCC -> CCCGGTCGTGTCTAGTCCT
GCTTAAGTTATTCGGCGAT -> CTTAAGTTATTCGGCGATT
TTGGCATTACATATTTTAA -> TGGCATTACATATTTTAAT
CCGGTCGTGTCTAGTCCTA -> CGGTCGTGTCTAGTCCTAT
CTATAAACGTCCCGTCGGT -> TATAAACGTCCCGTCGGTC
GTGGACTTTGTTGTTGTAT -> TGGACTTTGTTGTTGTATA
AATTGTCTATTTCGTGTAG -> ATTGTCTATTTCGTGTAGA
GGCGGAAAGCTTACTGAAA -> GCGGAAAGCTTACTGAAAT
ATCTAAGCTGCAAGTCACG -> TCTAAGCTGCAAGTCACGT
ATAAAGCGTACCTGGTGAG -> TAAAGCGTACCTGGTGAGG
CCTCCGGCCCACCCAGTTC -> CTCCGGCCCACCCAGTTCG
CTCTTCACGCATTAGTGGC -> TCTTCACGCATTAGTGGCG
AGGAGCTACCCGGATACTG -> GGAGCTACCCGGATACTGT
GATCGCGTGATGAGAAGGC -> ATCGCGTGATGAGAAGGCC
GACCAGGCAATGGGAACCC -> ACCAGGCAATGGGAACCCA
GGGATCAAGCCTATAAACG -> GGATCAAGCCTATAAACGT
CTGCATGAAGGTCTTGATC -> TGCATGAAGGTCTTGATCG
TCGTTGACCTACCTGGGCC -> CGTTGACCTACCTGGGCCA
GTGAGGATAAAGCGTACCT -> TGAGGATAAAGCGTACCTG
AGCCTGCCCACTGCGCCGA -> GCCTGCCCACTGCGCCGAT
TACAAAGACGCACTTAGAC -> ACAAAGACGCACTTAGACC
TAAGAAATCCGTAGGAGCT -> AAGAAATCCGTAGGAGCTA
GCCGCCGGGTCTGTGAAAC -> CCGCCGGGTCTGTGAAACT
GCGGGACGATCCTGAAATT -> CGGGACGATCCTGAAATTA
TCCTGATGTGTAAATCCCA -> CCTGATGTGTAAATCCCAA
TAAAAAACTACCCTATTGG -> AAAAAACTACCCTATTGGG
TGTCGACACTGGATTCTCG -> GTCGACACTGGATTCTCGG
TACCCGGATACTGTAAGGA -> ACCCGGATACTGTAAGGAC
GTGTCTTGTAGGGCATGGG -> TGTCTTGTAGGGCATGGGC
TTCGGGGGCATCGGGGCAC -> TCGGGGGCATCGGGGCACT
TTAAGAAATCCGTAGGAGC -> TAAGAAATCCGTAGGAGCT
ATGTTTGCCGTTAAGCTCG -> TGTTTGCCGTTAAGCTCGA
AGGTAGTGTCGACCAAATC -> GGTAGTGTCGACCAAATCG
CTCCGGCAAGTGGACTTTG -> TCCGGCAAGTGGACTTTGT
GTTAGTAGTATTTTATGCG -> TTAGTAGTATTTTATGCGT
CTAAGCTGCAAGTCACGTG -> TAAGCTGCAAGTCACGTGG
TGGGCATCGATTTCTGCGA -> GGGCATCGATTTCTGCGAT
TCAGATAGCACCCGCACTA -> CAGATAGCACCCGCACTAC
AGACGAACTGTCCAAGCAT -> GACGAACTGTCCAAGCATA
TTTACAAAATTAGCGATGG -> TTACAAAATTAGCGATGGT
CTGTGAAACTATACAAAGA -> TGTGAAACTATACAAAGAC
AGCTCTCGTGCCGTCGGTC -> GCTCTCGTGCCGTCGGTCC
TCCGTCCAAGAGAGGGACT -> CCGTCCAAGAGAGGGACTC
GGCGCTATTAACATAGACA -> GCGCTATTAACATAGACAC
CTGCTTATCTTGCACGATC -> TGCTTATCTTGCACGATCC
TATTCGGCGATTGGCATTA -> ATTCGGCGATTGGCATTAC